Codice comune;Comune;Maschi;Femmine;Totale;Cittadinanza;Zona geografica;Continente
58001;Affile;8;13;21;Romania;Unione Europea;Europa
58001;Affile;5;3;8;Perù;America Centro-Meridionale;America
58001;Affile;0;5;5;Dominicana, Repubblica;America Centro-Meridionale;America
58001;Affile;1;3;4;Albania;Europa Centro-Orientale;Europa
58001;Affile;2;1;3;Nigeria;Africa Occidentale;Africa
58001;Affile;0;1;1;Spagna;Unione Europea;Europa
58002;Agosta;34;46;80;Romania;Unione Europea;Europa
58002;Agosta;2;5;7;Congo, Repubblica democratica del (ex Zaire);Africa Centro-Meridionale;Africa
58002;Agosta;3;3;6;Albania;Europa Centro-Orientale;Europa
58002;Agosta;0;6;6;Moldova;Europa Centro-Orientale;Europa
58002;Agosta;3;3;6;Polonia;Unione Europea;Europa
58002;Agosta;3;1;4;Georgia;Asia Occidentale;Asia
58002;Agosta;1;2;3;Congo (Repubblica del);Africa Centro-Meridionale;Africa
58002;Agosta;1;1;2;Croazia;Unione Europea;Europa
58002;Agosta;1;1;2;Kenya;Africa Orientale;Africa
58002;Agosta;2;0;2;Marocco;Africa Settentrionale;Africa
58002;Agosta;1;1;2;Nigeria;Africa Occidentale;Africa
58002;Agosta;1;0;1;Camerun;Africa Centro-Meridionale;Africa
58002;Agosta;1;0;1;Centrafricana, Repubblica;Africa Centro-Meridionale;Africa
58002;Agosta;0;1;1;Egitto;Africa Settentrionale;Africa
58002;Agosta;0;1;1;Francia;Unione Europea;Europa
58002;Agosta;0;1;1;Ucraina;Europa Centro-Orientale;Europa
58003;Albano Laziale;897;899;1796;Romania;Unione Europea;Europa
58003;Albano Laziale;97;105;202;Albania;Europa Centro-Orientale;Europa
58003;Albano Laziale;83;59;142;Egitto;Africa Settentrionale;Africa
58003;Albano Laziale;101;31;132;Bangladesh;Asia Centro-Meridionale;Asia
58003;Albano Laziale;71;60;131;India;Asia Centro-Meridionale;Asia
58003;Albano Laziale;23;106;129;Ucraina;Europa Centro-Orientale;Europa
58003;Albano Laziale;45;46;91;Cinese, Repubblica Popolare;Asia Orientale;Asia
58003;Albano Laziale;23;62;85;Polonia;Unione Europea;Europa
58003;Albano Laziale;27;50;77;Moldova;Europa Centro-Orientale;Europa
58003;Albano Laziale;40;21;61;Pakistan;Asia Centro-Meridionale;Asia
58003;Albano Laziale;37;24;61;Tunisia;Africa Settentrionale;Africa
58003;Albano Laziale;14;31;45;Spagna;Unione Europea;Europa
58003;Albano Laziale;18;15;33;Turchia;Europa Centro-Orientale;Europa
58003;Albano Laziale;19;11;30;Marocco;Africa Settentrionale;Africa
58003;Albano Laziale;12;14;26;Perù;America Centro-Meridionale;America
58003;Albano Laziale;10;15;25;Francia;Unione Europea;Europa
58003;Albano Laziale;10;12;22;Ecuador;America Centro-Meridionale;America
58003;Albano Laziale;5;16;21;Georgia;Asia Occidentale;Asia
58003;Albano Laziale;10;9;19;Bulgaria;Unione Europea;Europa
58003;Albano Laziale;3;15;18;Brasile;America Centro-Meridionale;America
58003;Albano Laziale;5;11;16;Filippine;Asia Orientale;Asia
58003;Albano Laziale;5;10;15;Germania;Unione Europea;Europa
58003;Albano Laziale;2;12;14;Cuba;America Centro-Meridionale;America
58003;Albano Laziale;3;10;13;Russa, Federazione;Europa Centro-Orientale;Europa
58003;Albano Laziale;11;2;13;Sri Lanka (ex Ceylon);Asia Centro-Meridionale;Asia
58003;Albano Laziale;7;5;12;Dominicana, Repubblica;America Centro-Meridionale;America
58003;Albano Laziale;4;8;12;Regno Unito;Altri paesi europei;Europa
58003;Albano Laziale;3;8;11;Iran, Repubblica Islamica del;Asia Occidentale;Asia
58003;Albano Laziale;2;8;10;Nigeria;Africa Occidentale;Africa
58003;Albano Laziale;6;4;10;Senegal;Africa Occidentale;Africa
58003;Albano Laziale;3;7;10;Stati Uniti d'America;America Settentrionale;America
58003;Albano Laziale;4;4;8;Argentina;America Centro-Meridionale;America
58003;Albano Laziale;6;1;7;Algeria;Africa Settentrionale;Africa
58003;Albano Laziale;4;3;7;Colombia;America Centro-Meridionale;America
58003;Albano Laziale;1;6;7;El Salvador;America Centro-Meridionale;America
58003;Albano Laziale;2;5;7;Paesi Bassi;Unione Europea;Europa
58003;Albano Laziale;4;2;6;Afghanistan;Asia Centro-Meridionale;Asia
58003;Albano Laziale;3;3;6;Camerun;Africa Centro-Meridionale;Africa
58003;Albano Laziale;1;5;6;Capo Verde;Africa Occidentale;Africa
58003;Albano Laziale;3;3;6;Montenegro;Europa Centro-Orientale;Europa
58003;Albano Laziale;3;3;6;Portogallo;Unione Europea;Europa
58003;Albano Laziale;1;4;5;Belgio;Unione Europea;Europa
58003;Albano Laziale;0;5;5;Honduras;America Centro-Meridionale;America
58003;Albano Laziale;2;3;5;Messico;America Centro-Meridionale;America
58003;Albano Laziale;0;5;5;Svezia;Unione Europea;Europa
58003;Albano Laziale;2;2;4;Benin (ex Dahomey);Africa Occidentale;Africa
58003;Albano Laziale;3;1;4;Macedonia del Nord;Europa Centro-Orientale;Europa
58003;Albano Laziale;1;2;3;Giappone;Asia Orientale;Asia
58003;Albano Laziale;2;1;3;Kosovo;Europa Centro-Orientale;Europa
58003;Albano Laziale;2;1;3;Madagascar;Africa Orientale;Africa
58003;Albano Laziale;1;2;3;Mauritius;Africa Orientale;Africa
58003;Albano Laziale;0;2;2;Bielorussia;Europa Centro-Orientale;Europa
58003;Albano Laziale;1;1;2;Ceca, Repubblica;Unione Europea;Europa
58003;Albano Laziale;1;1;2;Costa d'Avorio;Africa Occidentale;Africa
58003;Albano Laziale;0;2;2;Eritrea;Africa Orientale;Africa
58003;Albano Laziale;1;1;2;Ghana;Africa Occidentale;Africa
58003;Albano Laziale;0;2;2;Kazakhstan;Asia Centro-Meridionale;Asia
58003;Albano Laziale;0;2;2;Lituania;Unione Europea;Europa
58003;Albano Laziale;0;2;2;Panama;America Centro-Meridionale;America
58003;Albano Laziale;0;2;2;Serbia, Repubblica di;Europa Centro-Orientale;Europa
58003;Albano Laziale;0;2;2;Siria;Asia Occidentale;Asia
58003;Albano Laziale;0;2;2;Thailandia;Asia Orientale;Asia
58003;Albano Laziale;2;0;2;Togo;Africa Occidentale;Africa
58003;Albano Laziale;0;2;2;Ungheria;Unione Europea;Europa
58003;Albano Laziale;0;2;2;Venezuela;America Centro-Meridionale;America
58003;Albano Laziale;1;0;1;Angola;Africa Centro-Meridionale;Africa
58003;Albano Laziale;0;1;1;Austria;Unione Europea;Europa
58003;Albano Laziale;0;1;1;Bosnia-Erzegovina;Europa Centro-Orientale;Europa
58003;Albano Laziale;1;0;1;Burkina Faso (ex Alto Volta);Africa Occidentale;Africa
58003;Albano Laziale;1;0;1;Burundi;Africa Orientale;Africa
58003;Albano Laziale;0;1;1;Canada;America Settentrionale;America
58003;Albano Laziale;0;1;1;Cile;America Centro-Meridionale;America
58003;Albano Laziale;0;1;1;Congo (Repubblica del);Africa Centro-Meridionale;Africa
58003;Albano Laziale;0;1;1;Corea, Repubblica (Corea del Sud);Asia Orientale;Asia
58003;Albano Laziale;1;0;1;Costa Rica;America Centro-Meridionale;America
58003;Albano Laziale;0;1;1;Croazia;Unione Europea;Europa
58003;Albano Laziale;1;0;1;Danimarca;Unione Europea;Europa
58003;Albano Laziale;1;0;1;Etiopia;Africa Orientale;Africa
58003;Albano Laziale;1;0;1;Gambia;Africa Occidentale;Africa
58003;Albano Laziale;1;0;1;Grecia;Unione Europea;Europa
58003;Albano Laziale;1;0;1;Guatemala;America Centro-Meridionale;America
58003;Albano Laziale;1;0;1;Guinea;Africa Occidentale;Africa
58003;Albano Laziale;1;0;1;Iraq;Asia Occidentale;Asia
58003;Albano Laziale;0;1;1;Kirghizistan;Asia Centro-Meridionale;Asia
58003;Albano Laziale;0;1;1;Lettonia;Unione Europea;Europa
58003;Albano Laziale;0;1;1;Malta;Unione Europea;Europa
58003;Albano Laziale;0;1;1;Mongolia;Asia Orientale;Asia
58003;Albano Laziale;1;0;1;Mozambico;Africa Orientale;Africa
58003;Albano Laziale;0;1;1;Norvegia;Altri paesi europei;Europa
58003;Albano Laziale;0;1;1;Paraguay;America Centro-Meridionale;America
58003;Albano Laziale;1;0;1;Sierra Leone;Africa Occidentale;Africa
58003;Albano Laziale;0;1;1;Slovacchia;Unione Europea;Europa
58003;Albano Laziale;1;0;1;Sud Africa;Africa Centro-Meridionale;Africa
58004;Allumiere;69;71;140;Romania;Unione Europea;Europa
58004;Allumiere;5;6;11;Albania;Europa Centro-Orientale;Europa
58004;Allumiere;1;4;5;Polonia;Unione Europea;Europa
58004;Allumiere;2;2;4;Nigeria;Africa Occidentale;Africa
58004;Allumiere;2;1;3;Cinese, Repubblica Popolare;Asia Orientale;Asia
58004;Allumiere;3;0;3;Iraq;Asia Occidentale;Asia
58004;Allumiere;1;1;2;Brasile;America Centro-Meridionale;America
58004;Allumiere;0;2;2;Cuba;America Centro-Meridionale;America
58004;Allumiere;1;1;2;Lituania;Unione Europea;Europa
58004;Allumiere;1;1;2;Sri Lanka (ex Ceylon);Asia Centro-Meridionale;Asia
58004;Allumiere;0;2;2;Ucraina;Europa Centro-Orientale;Europa
58004;Allumiere;0;1;1;Algeria;Africa Settentrionale;Africa
58004;Allumiere;1;0;1;Bangladesh;Asia Centro-Meridionale;Asia
58004;Allumiere;0;1;1;Francia;Unione Europea;Europa
58004;Allumiere;0;1;1;Giamaica;America Centro-Meridionale;America
58004;Allumiere;0;1;1;Haiti;America Centro-Meridionale;America
58004;Allumiere;0;1;1;Marocco;Africa Settentrionale;Africa
58004;Allumiere;0;1;1;Paesi Bassi;Unione Europea;Europa
58004;Allumiere;0;1;1;Perù;America Centro-Meridionale;America
58004;Allumiere;0;1;1;Regno Unito;Altri paesi europei;Europa
58004;Allumiere;1;0;1;Russa, Federazione;Europa Centro-Orientale;Europa
58004;Allumiere;1;0;1;Tunisia;Africa Settentrionale;Africa
58005;Anguillara Sabazia;378;445;823;Romania;Unione Europea;Europa
58005;Anguillara Sabazia;50;71;121;Polonia;Unione Europea;Europa
58005;Anguillara Sabazia;50;40;90;Albania;Europa Centro-Orientale;Europa
58005;Anguillara Sabazia;27;62;89;Ucraina;Europa Centro-Orientale;Europa
58005;Anguillara Sabazia;22;38;60;Perù;America Centro-Meridionale;America
58005;Anguillara Sabazia;21;20;41;Macedonia del Nord;Europa Centro-Orientale;Europa
58005;Anguillara Sabazia;20;20;40;India;Asia Centro-Meridionale;Asia
58005;Anguillara Sabazia;33;6;39;Egitto;Africa Settentrionale;Africa
58005;Anguillara Sabazia;11;18;29;Regno Unito;Altri paesi europei;Europa
58005;Anguillara Sabazia;12;15;27;Bangladesh;Asia Centro-Meridionale;Asia
58005;Anguillara Sabazia;15;11;26;Algeria;Africa Settentrionale;Africa
58005;Anguillara Sabazia;13;13;26;El Salvador;America Centro-Meridionale;America
58005;Anguillara Sabazia;8;17;25;Moldova;Europa Centro-Orientale;Europa
58005;Anguillara Sabazia;9;13;22;Francia;Unione Europea;Europa
58005;Anguillara Sabazia;3;13;16;Germania;Unione Europea;Europa
58005;Anguillara Sabazia;11;5;16;Marocco;Africa Settentrionale;Africa
58005;Anguillara Sabazia;9;5;14;Sri Lanka (ex Ceylon);Asia Centro-Meridionale;Asia
58005;Anguillara Sabazia;7;6;13;Filippine;Asia Orientale;Asia
58005;Anguillara Sabazia;4;9;13;Spagna;Unione Europea;Europa
58005;Anguillara Sabazia;1;10;11;Brasile;America Centro-Meridionale;America
58005;Anguillara Sabazia;3;8;11;Ecuador;America Centro-Meridionale;America
58005;Anguillara Sabazia;2;8;10;Stati Uniti d'America;America Settentrionale;America
58005;Anguillara Sabazia;3;6;9;Venezuela;America Centro-Meridionale;America
58005;Anguillara Sabazia;3;5;8;Bulgaria;Unione Europea;Europa
58005;Anguillara Sabazia;4;4;8;Colombia;America Centro-Meridionale;America
58005;Anguillara Sabazia;0;8;8;Russa, Federazione;Europa Centro-Orientale;Europa
58005;Anguillara Sabazia;5;3;8;Tunisia;Africa Settentrionale;Africa
58005;Anguillara Sabazia;3;4;7;Libia;Africa Settentrionale;Africa
58005;Anguillara Sabazia;5;2;7;Senegal;Africa Occidentale;Africa
58005;Anguillara Sabazia;5;2;7;Serbia, Repubblica di;Europa Centro-Orientale;Europa
58005;Anguillara Sabazia;3;3;6;Cinese, Repubblica Popolare;Asia Orientale;Asia
58005;Anguillara Sabazia;3;2;5;Argentina;America Centro-Meridionale;America
58005;Anguillara Sabazia;0;5;5;Bielorussia;Europa Centro-Orientale;Europa
58005;Anguillara Sabazia;2;3;5;Corea, Repubblica (Corea del Sud);Asia Orientale;Asia
58005;Anguillara Sabazia;0;5;5;Georgia;Asia Occidentale;Asia
58005;Anguillara Sabazia;2;3;5;Nigeria;Africa Occidentale;Africa
58005;Anguillara Sabazia;1;4;5;Paesi Bassi;Unione Europea;Europa
58005;Anguillara Sabazia;1;3;4;Ceca, Repubblica;Unione Europea;Europa
58005;Anguillara Sabazia;1;3;4;Cuba;America Centro-Meridionale;America
58005;Anguillara Sabazia;0;4;4;Giappone;Asia Orientale;Asia
58005;Anguillara Sabazia;1;2;3;Costa d'Avorio;Africa Occidentale;Africa
58005;Anguillara Sabazia;1;2;3;Croazia;Unione Europea;Europa
58005;Anguillara Sabazia;1;2;3;Dominicana, Repubblica;America Centro-Meridionale;America
58005;Anguillara Sabazia;3;0;3;Iraq;Asia Occidentale;Asia
58005;Anguillara Sabazia;1;2;3;Libano;Asia Occidentale;Asia
58005;Anguillara Sabazia;3;0;3;Pakistan;Asia Centro-Meridionale;Asia
58005;Anguillara Sabazia;0;3;3;Portogallo;Unione Europea;Europa
58005;Anguillara Sabazia;2;1;3;Svezia;Unione Europea;Europa
58005;Anguillara Sabazia;1;1;2;Angola;Africa Centro-Meridionale;Africa
58005;Anguillara Sabazia;0;2;2;Austria;Unione Europea;Europa
58005;Anguillara Sabazia;1;1;2;Finlandia;Unione Europea;Europa
58005;Anguillara Sabazia;1;1;2;Israele;Asia Occidentale;Asia
58005;Anguillara Sabazia;1;1;2;Lettonia;Unione Europea;Europa
58005;Anguillara Sabazia;1;1;2;Madagascar;Africa Orientale;Africa
58005;Anguillara Sabazia;0;2;2;Messico;America Centro-Meridionale;America
58005;Anguillara Sabazia;1;1;2;Norvegia;Altri paesi europei;Europa
58005;Anguillara Sabazia;1;1;2;Ruanda;Africa Orientale;Africa
58005;Anguillara Sabazia;0;2;2;Slovacchia;Unione Europea;Europa
58005;Anguillara Sabazia;1;1;2;Ungheria;Unione Europea;Europa
58005;Anguillara Sabazia;0;1;1;Belgio;Unione Europea;Europa
58005;Anguillara Sabazia;0;1;1;Bosnia-Erzegovina;Europa Centro-Orientale;Europa
58005;Anguillara Sabazia;1;0;1;Burkina Faso (ex Alto Volta);Africa Occidentale;Africa
58005;Anguillara Sabazia;0;1;1;Canada;America Settentrionale;America
58005;Anguillara Sabazia;0;1;1;Congo (Repubblica del);Africa Centro-Meridionale;Africa
58005;Anguillara Sabazia;0;1;1;Danimarca;Unione Europea;Europa
58005;Anguillara Sabazia;1;0;1;Eritrea;Africa Orientale;Africa
58005;Anguillara Sabazia;0;1;1;Etiopia;Africa Orientale;Africa
58005;Anguillara Sabazia;1;0;1;Grecia;Unione Europea;Europa
58005;Anguillara Sabazia;0;1;1;Guinea;Africa Occidentale;Africa
58005;Anguillara Sabazia;1;0;1;Guinea Bissau;Africa Occidentale;Africa
58005;Anguillara Sabazia;0;1;1;Honduras;America Centro-Meridionale;America
58005;Anguillara Sabazia;1;0;1;Irlanda;Unione Europea;Europa
58005;Anguillara Sabazia;0;1;1;Kenya;Africa Orientale;Africa
58005;Anguillara Sabazia;0;1;1;Lituania;Unione Europea;Europa
58005;Anguillara Sabazia;1;0;1;Mali;Africa Occidentale;Africa
58005;Anguillara Sabazia;0;1;1;Nuova Zelanda;Oceania;Oceania
58005;Anguillara Sabazia;0;1;1;Paraguay;America Centro-Meridionale;America
58005;Anguillara Sabazia;1;0;1;San Marino;Altri paesi europei;Europa
58005;Anguillara Sabazia;1;0;1;Sierra Leone;Africa Occidentale;Africa
58005;Anguillara Sabazia;0;1;1;Siria;Asia Occidentale;Asia
58005;Anguillara Sabazia;0;1;1;Uganda;Africa Orientale;Africa
58005;Anguillara Sabazia;1;0;1;Uruguay;America Centro-Meridionale;America
58006;Anticoli Corrado;18;17;35;Romania;Unione Europea;Europa
58006;Anticoli Corrado;13;0;13;Egitto;Africa Settentrionale;Africa
58006;Anticoli Corrado;3;2;5;Nigeria;Africa Occidentale;Africa
58006;Anticoli Corrado;0;3;3;Brasile;America Centro-Meridionale;America
58006;Anticoli Corrado;1;2;3;Germania;Unione Europea;Europa
58006;Anticoli Corrado;0;3;3;Ucraina;Europa Centro-Orientale;Europa
58006;Anticoli Corrado;0;1;1;Ceca, Repubblica;Unione Europea;Europa
58006;Anticoli Corrado;1;0;1;Cinese, Repubblica Popolare;Asia Orientale;Asia
58006;Anticoli Corrado;0;1;1;Iran, Repubblica Islamica del;Asia Occidentale;Asia
58006;Anticoli Corrado;1;0;1;Iraq;Asia Occidentale;Asia
58006;Anticoli Corrado;1;0;1;Marocco;Africa Settentrionale;Africa
58006;Anticoli Corrado;0;1;1;Polonia;Unione Europea;Europa
58006;Anticoli Corrado;0;1;1;Regno Unito;Altri paesi europei;Europa
58006;Anticoli Corrado;0;1;1;Ruanda;Africa Orientale;Africa
58006;Anticoli Corrado;1;0;1;Territori dell'Autonomia Palestinese;Asia Occidentale;Asia
58006;Anticoli Corrado;0;1;1;Venezuela;America Centro-Meridionale;America
58006;Anticoli Corrado;1;0;1;Yemen;Asia Occidentale;Asia
58007;Anzio;1351;515;1866;India;Asia Centro-Meridionale;Asia
58007;Anzio;673;785;1458;Romania;Unione Europea;Europa
58007;Anzio;548;163;711;Pakistan;Asia Centro-Meridionale;Asia
58007;Anzio;371;170;541;Marocco;Africa Settentrionale;Africa
58007;Anzio;234;279;513;Bulgaria;Unione Europea;Europa
58007;Anzio;160;127;287;Nigeria;Africa Occidentale;Africa
58007;Anzio;142;72;214;Tunisia;Africa Settentrionale;Africa
58007;Anzio;61;149;210;Ucraina;Europa Centro-Orientale;Europa
58007;Anzio;61;95;156;Moldova;Europa Centro-Orientale;Europa
58007;Anzio;41;103;144;Polonia;Unione Europea;Europa
58007;Anzio;62;55;117;Albania;Europa Centro-Orientale;Europa
58007;Anzio;46;63;109;Perù;America Centro-Meridionale;America
58007;Anzio;84;22;106;Bangladesh;Asia Centro-Meridionale;Asia
58007;Anzio;69;28;97;Egitto;Africa Settentrionale;Africa
58007;Anzio;44;46;90;Cinese, Repubblica Popolare;Asia Orientale;Asia
58007;Anzio;22;63;85;Russa, Federazione;Europa Centro-Orientale;Europa
58007;Anzio;17;42;59;Brasile;America Centro-Meridionale;America
58007;Anzio;12;31;43;Cuba;America Centro-Meridionale;America
58007;Anzio;11;21;32;Filippine;Asia Orientale;Asia
58007;Anzio;12;20;32;Germania;Unione Europea;Europa
58007;Anzio;12;18;30;Regno Unito;Altri paesi europei;Europa
58007;Anzio;12;17;29;Francia;Unione Europea;Europa
58007;Anzio;8;21;29;Spagna;Unione Europea;Europa
58007;Anzio;14;12;26;Iran, Repubblica Islamica del;Asia Occidentale;Asia
58007;Anzio;12;13;25;Ecuador;America Centro-Meridionale;America
58007;Anzio;22;2;24;Afghanistan;Asia Centro-Meridionale;Asia
58007;Anzio;14;10;24;Sri Lanka (ex Ceylon);Asia Centro-Meridionale;Asia
58007;Anzio;19;4;23;Algeria;Africa Settentrionale;Africa
58007;Anzio;18;4;22;Senegal;Africa Occidentale;Africa
58007;Anzio;8;12;20;Venezuela;America Centro-Meridionale;America
58007;Anzio;7;10;17;Stati Uniti d'America;America Settentrionale;America
58007;Anzio;6;10;16;Ceca, Repubblica;Unione Europea;Europa
58007;Anzio;6;10;16;Colombia;America Centro-Meridionale;America
58007;Anzio;6;9;15;Capo Verde;Africa Occidentale;Africa
58007;Anzio;8;6;14;Sierra Leone;Africa Occidentale;Africa
58007;Anzio;6;7;13;Macedonia del Nord;Europa Centro-Orientale;Europa
58007;Anzio;9;4;13;Turchia;Europa Centro-Orientale;Europa
58007;Anzio;3;9;12;Argentina;America Centro-Meridionale;America
58007;Anzio;3;7;10;Portogallo;Unione Europea;Europa
58007;Anzio;3;7;10;Svizzera;Altri paesi europei;Europa
58007;Anzio;3;6;9;Siria;Asia Occidentale;Asia
58007;Anzio;3;6;9;Ungheria;Unione Europea;Europa
58007;Anzio;4;4;8;Congo (Repubblica del);Africa Centro-Meridionale;Africa
58007;Anzio;2;6;8;Georgia;Asia Occidentale;Asia
58007;Anzio;2;6;8;Honduras;America Centro-Meridionale;America
58007;Anzio;5;3;8;Libia;Africa Settentrionale;Africa
58007;Anzio;3;5;8;Paesi Bassi;Unione Europea;Europa
58007;Anzio;4;4;8;Togo;Africa Occidentale;Africa
58007;Anzio;0;7;7;Bielorussia;Europa Centro-Orientale;Europa
58007;Anzio;3;4;7;Etiopia;Africa Orientale;Africa
58007;Anzio;6;1;7;Ghana;Africa Occidentale;Africa
58007;Anzio;1;6;7;Libano;Asia Occidentale;Asia
58007;Anzio;7;0;7;Mali;Africa Occidentale;Africa
58007;Anzio;1;5;6;Belgio;Unione Europea;Europa
58007;Anzio;4;2;6;Bosnia-Erzegovina;Europa Centro-Orientale;Europa
58007;Anzio;1;5;6;Grecia;Unione Europea;Europa
58007;Anzio;1;5;6;Lituania;Unione Europea;Europa
58007;Anzio;0;6;6;Thailandia;Asia Orientale;Asia
58007;Anzio;5;0;5;Gambia;Africa Occidentale;Africa
58007;Anzio;5;0;5;Guinea;Africa Occidentale;Africa
58007;Anzio;0;5;5;Indonesia;Asia Orientale;Asia
58007;Anzio;2;3;5;Kazakhstan;Asia Centro-Meridionale;Asia
58007;Anzio;2;3;5;Slovacchia;Unione Europea;Europa
58007;Anzio;1;4;5;Somalia;Africa Orientale;Africa
58007;Anzio;2;3;5;Uruguay;America Centro-Meridionale;America
58007;Anzio;2;2;4;Angola;Africa Centro-Meridionale;Africa
58007;Anzio;0;4;4;Austria;Unione Europea;Europa
58007;Anzio;4;0;4;Camerun;Africa Centro-Meridionale;Africa
58007;Anzio;3;1;4;Costa d'Avorio;Africa Occidentale;Africa
58007;Anzio;2;2;4;Croazia;Unione Europea;Europa
58007;Anzio;2;2;4;Dominicana, Repubblica;America Centro-Meridionale;America
58007;Anzio;2;2;4;Kenya;Africa Orientale;Africa
58007;Anzio;1;3;4;Liberia;Africa Occidentale;Africa
58007;Anzio;0;4;4;Mozambico;Africa Orientale;Africa
58007;Anzio;2;2;4;Niger;Africa Occidentale;Africa
58007;Anzio;2;1;3;Armenia;Asia Occidentale;Asia
58007;Anzio;2;1;3;Dominica;America Centro-Meridionale;America
58007;Anzio;1;2;3;Giappone;Asia Orientale;Asia
58007;Anzio;0;3;3;Messico;America Centro-Meridionale;America
58007;Anzio;1;2;3;Serbia, Repubblica di;Europa Centro-Orientale;Europa
58007;Anzio;2;0;2;Benin (ex Dahomey);Africa Occidentale;Africa
58007;Anzio;1;1;2;Canada;America Settentrionale;America
58007;Anzio;0;2;2;Cile;America Centro-Meridionale;America
58007;Anzio;2;0;2;Congo, Repubblica democratica del (ex Zaire);Africa Centro-Meridionale;Africa
58007;Anzio;1;1;2;Eritrea;Africa Orientale;Africa
58007;Anzio;1;1;2;Giordania;Asia Occidentale;Asia
58007;Anzio;1;1;2;Lettonia;Unione Europea;Europa
58007;Anzio;1;1;2;Nepal;Asia Centro-Meridionale;Asia
58007;Anzio;0;2;2;Nicaragua;America Centro-Meridionale;America
58007;Anzio;1;1;2;Norvegia;Altri paesi europei;Europa
58007;Anzio;2;0;2;Territori dell'Autonomia Palestinese;Asia Occidentale;Asia
58007;Anzio;0;1;1;Bolivia;America Centro-Meridionale;America
58007;Anzio;0;1;1;Burkina Faso (ex Alto Volta);Africa Occidentale;Africa
58007;Anzio;0;1;1;Corea, Repubblica (Corea del Sud);Asia Orientale;Asia
58007;Anzio;0;1;1;Costa Rica;America Centro-Meridionale;America
58007;Anzio;1;0;1;Danimarca;Unione Europea;Europa
58007;Anzio;0;1;1;Estonia;Unione Europea;Europa
58007;Anzio;0;1;1;Finlandia;Unione Europea;Europa
58007;Anzio;0;1;1;Guatemala;America Centro-Meridionale;America
58007;Anzio;1;0;1;Guinea Bissau;Africa Occidentale;Africa
58007;Anzio;1;0;1;Irlanda;Unione Europea;Europa
58007;Anzio;0;1;1;Islanda;Altri paesi europei;Europa
58007;Anzio;0;1;1;Israele;Asia Occidentale;Asia
58007;Anzio;0;1;1;Kosovo;Europa Centro-Orientale;Europa
58007;Anzio;0;1;1;Malawi;Africa Orientale;Africa
58007;Anzio;0;1;1;Mauritania;Africa Occidentale;Africa
58007;Anzio;1;0;1;Sud Africa;Africa Centro-Meridionale;Africa
58007;Anzio;0;1;1;Sudan;Africa Settentrionale;Africa
58007;Anzio;1;0;1;Svezia;Unione Europea;Europa
58007;Anzio;0;1;1;Taiwan (ex Formosa);Asia Orientale;Asia
58007;Anzio;0;1;1;Vietnam;Asia Orientale;Asia
58008;Arcinazzo Romano;6;6;12;Romania;Unione Europea;Europa
58008;Arcinazzo Romano;1;2;3;Nigeria;Africa Occidentale;Africa
58008;Arcinazzo Romano;1;0;1;Albania;Europa Centro-Orientale;Europa
58008;Arcinazzo Romano;1;0;1;Congo (Repubblica del);Africa Centro-Meridionale;Africa
58008;Arcinazzo Romano;1;0;1;Dominicana, Repubblica;America Centro-Meridionale;America
58008;Arcinazzo Romano;1;0;1;Macedonia del Nord;Europa Centro-Orientale;Europa
58008;Arcinazzo Romano;0;1;1;Polonia;Unione Europea;Europa
58008;Arcinazzo Romano;1;0;1;Regno Unito;Altri paesi europei;Europa
58008;Arcinazzo Romano;0;1;1;Senegal;Africa Occidentale;Africa
58008;Arcinazzo Romano;0;1;1;Spagna;Unione Europea;Europa
58117;Ardea;1251;1364;2615;Romania;Unione Europea;Europa
58117;Ardea;375;145;520;India;Asia Centro-Meridionale;Asia
58117;Ardea;290;80;370;Marocco;Africa Settentrionale;Africa
58117;Ardea;160;182;342;Bulgaria;Unione Europea;Europa
58117;Ardea;116;196;312;Polonia;Unione Europea;Europa
58117;Ardea;60;156;216;Ucraina;Europa Centro-Orientale;Europa
58117;Ardea;91;85;176;Albania;Europa Centro-Orientale;Europa
58117;Ardea;131;45;176;Tunisia;Africa Settentrionale;Africa
58117;Ardea;62;73;135;Moldova;Europa Centro-Orientale;Europa
58117;Ardea;105;17;122;Bangladesh;Asia Centro-Meridionale;Asia
58117;Ardea;85;37;122;Pakistan;Asia Centro-Meridionale;Asia
58117;Ardea;66;41;107;Macedonia del Nord;Europa Centro-Orientale;Europa
58117;Ardea;67;17;84;Egitto;Africa Settentrionale;Africa
58117;Ardea;33;33;66;Cinese, Repubblica Popolare;Asia Orientale;Asia
58117;Ardea;23;42;65;Filippine;Asia Orientale;Asia
58117;Ardea;13;40;53;Brasile;America Centro-Meridionale;America
58117;Ardea;21;25;46;Perù;America Centro-Meridionale;America
58117;Ardea;14;27;41;Russa, Federazione;Europa Centro-Orientale;Europa
58117;Ardea;13;27;40;Cuba;America Centro-Meridionale;America
58117;Ardea;20;19;39;Nigeria;Africa Occidentale;Africa
58117;Ardea;19;15;34;Bosnia-Erzegovina;Europa Centro-Orientale;Europa
58117;Ardea;11;17;28;Francia;Unione Europea;Europa
58117;Ardea;8;16;24;Ecuador;America Centro-Meridionale;America
58117;Ardea;11;12;23;Colombia;America Centro-Meridionale;America
58117;Ardea;8;14;22;Regno Unito;Altri paesi europei;Europa
58117;Ardea;5;13;18;Germania;Unione Europea;Europa
58117;Ardea;8;8;16;Venezuela;America Centro-Meridionale;America
58117;Ardea;7;8;15;Kosovo;Europa Centro-Orientale;Europa
58117;Ardea;6;9;15;Spagna;Unione Europea;Europa
58117;Ardea;8;6;14;Serbia, Repubblica di;Europa Centro-Orientale;Europa
58117;Ardea;10;2;12;Senegal;Africa Occidentale;Africa
58117;Ardea;7;5;12;Sri Lanka (ex Ceylon);Asia Centro-Meridionale;Asia
58117;Ardea;7;3;10;Algeria;Africa Settentrionale;Africa
58117;Ardea;7;3;10;Croazia;Unione Europea;Europa
58117;Ardea;2;7;9;Argentina;America Centro-Meridionale;America
58117;Ardea;4;5;9;Bielorussia;Europa Centro-Orientale;Europa
58117;Ardea;0;8;8;Ceca, Repubblica;Unione Europea;Europa
58117;Ardea;4;4;8;Etiopia;Africa Orientale;Africa
58117;Ardea;4;4;8;Stati Uniti d'America;America Settentrionale;America
58117;Ardea;2;5;7;Guatemala;America Centro-Meridionale;America
58117;Ardea;5;2;7;Iraq;Asia Occidentale;Asia
58117;Ardea;2;5;7;Portogallo;Unione Europea;Europa
58117;Ardea;4;3;7;Siria;Asia Occidentale;Asia
58117;Ardea;5;2;7;Turchia;Europa Centro-Orientale;Europa
58117;Ardea;3;3;6;Armenia;Asia Occidentale;Asia
58117;Ardea;5;1;6;Camerun;Africa Centro-Meridionale;Africa
58117;Ardea;2;4;6;Capo Verde;Africa Occidentale;Africa
58117;Ardea;2;4;6;Finlandia;Unione Europea;Europa
58117;Ardea;0;5;5;Austria;Unione Europea;Europa
58117;Ardea;1;4;5;Giappone;Asia Orientale;Asia
58117;Ardea;3;2;5;Montenegro;Europa Centro-Orientale;Europa
58117;Ardea;1;3;4;Belgio;Unione Europea;Europa
58117;Ardea;3;1;4;Eritrea;Africa Orientale;Africa
58117;Ardea;0;4;4;Georgia;Asia Occidentale;Asia
58117;Ardea;2;2;4;Kenya;Africa Orientale;Africa
58117;Ardea;2;2;4;Libano;Asia Occidentale;Asia
58117;Ardea;3;1;4;Nicaragua;America Centro-Meridionale;America
58117;Ardea;2;2;4;Yemen;Asia Occidentale;Asia
58117;Ardea;2;1;3;Burkina Faso (ex Alto Volta);Africa Occidentale;Africa
58117;Ardea;1;2;3;El Salvador;America Centro-Meridionale;America
58117;Ardea;2;1;3;Honduras;America Centro-Meridionale;America
58117;Ardea;0;3;3;Iran, Repubblica Islamica del;Asia Occidentale;Asia
58117;Ardea;1;2;3;Paesi Bassi;Unione Europea;Europa
58117;Ardea;0;3;3;Slovacchia;Unione Europea;Europa
58117;Ardea;0;3;3;Ungheria;Unione Europea;Europa
58117;Ardea;1;1;2;Apolide;;
58117;Ardea;2;0;2;Canada;America Settentrionale;America
58117;Ardea;2;0;2;Cile;America Centro-Meridionale;America
58117;Ardea;1;1;2;Congo (Repubblica del);Africa Centro-Meridionale;Africa
58117;Ardea;1;1;2;Dominicana, Repubblica;America Centro-Meridionale;America
58117;Ardea;1;1;2;Ghana;Africa Occidentale;Africa
58117;Ardea;0;2;2;Grecia;Unione Europea;Europa
58117;Ardea;1;1;2;Irlanda;Unione Europea;Europa
58117;Ardea;1;1;2;Lituania;Unione Europea;Europa
58117;Ardea;0;2;2;Madagascar;Africa Orientale;Africa
58117;Ardea;1;1;2;Mali;Africa Occidentale;Africa
58117;Ardea;0;2;2;Messico;America Centro-Meridionale;America
58117;Ardea;1;1;2;Paraguay;America Centro-Meridionale;America
58117;Ardea;1;1;2;San Marino;Altri paesi europei;Europa
58117;Ardea;0;2;2;Somalia;Africa Orientale;Africa
58117;Ardea;0;2;2;Thailandia;Asia Orientale;Asia
58117;Ardea;1;0;1;Afghanistan;Asia Centro-Meridionale;Asia
58117;Ardea;1;0;1;Angola;Africa Centro-Meridionale;Africa
58117;Ardea;0;1;1;Bolivia;America Centro-Meridionale;America
58117;Ardea;1;0;1;Ciad;Africa Centro-Meridionale;Africa
58117;Ardea;1;0;1;Costa d'Avorio;Africa Occidentale;Africa
58117;Ardea;0;1;1;Haiti;America Centro-Meridionale;America
58117;Ardea;0;1;1;Indonesia;Asia Orientale;Asia
58117;Ardea;1;0;1;Israele;Asia Occidentale;Asia
58117;Ardea;0;1;1;Kazakhstan;Asia Centro-Meridionale;Asia
58117;Ardea;1;0;1;Kuwait;Asia Occidentale;Asia
58117;Ardea;0;1;1;Lettonia;Unione Europea;Europa
58117;Ardea;0;1;1;Liberia;Africa Occidentale;Africa
58117;Ardea;0;1;1;Mozambico;Africa Orientale;Africa
58117;Ardea;1;0;1;Nepal;Asia Centro-Meridionale;Asia
58117;Ardea;0;1;1;Norvegia;Altri paesi europei;Europa
58117;Ardea;0;1;1;Panama;America Centro-Meridionale;America
58117;Ardea;0;1;1;Ruanda;Africa Orientale;Africa
58117;Ardea;0;1;1;Seychelles;Africa Orientale;Africa
58117;Ardea;1;0;1;Sierra Leone;Africa Occidentale;Africa
58117;Ardea;0;1;1;Singapore;Asia Orientale;Asia
58117;Ardea;0;1;1;Slovenia;Unione Europea;Europa
58117;Ardea;0;1;1;Svezia;Unione Europea;Europa
58117;Ardea;0;1;1;Tanzania;Africa Orientale;Africa
58117;Ardea;1;0;1;Togo;Africa Occidentale;Africa
58117;Ardea;0;1;1;Uganda;Africa Orientale;Africa
58117;Ardea;1;0;1;Uruguay;America Centro-Meridionale;America
58009;Ariccia;264;321;585;Romania;Unione Europea;Europa
58009;Ariccia;56;66;122;Albania;Europa Centro-Orientale;Europa
58009;Ariccia;48;40;88;Pakistan;Asia Centro-Meridionale;Asia
58009;Ariccia;10;56;66;Ucraina;Europa Centro-Orientale;Europa
58009;Ariccia;14;29;43;Polonia;Unione Europea;Europa
58009;Ariccia;28;6;34;Bangladesh;Asia Centro-Meridionale;Asia
58009;Ariccia;27;6;33;Tunisia;Africa Settentrionale;Africa
58009;Ariccia;21;10;31;Egitto;Africa Settentrionale;Africa
58009;Ariccia;24;7;31;India;Asia Centro-Meridionale;Asia
58009;Ariccia;5;24;29;Nigeria;Africa Occidentale;Africa
58009;Ariccia;13;13;26;Perù;America Centro-Meridionale;America
58009;Ariccia;9;16;25;Cinese, Repubblica Popolare;Asia Orientale;Asia
58009;Ariccia;7;12;19;Germania;Unione Europea;Europa
58009;Ariccia;11;7;18;Marocco;Africa Settentrionale;Africa
58009;Ariccia;4;13;17;Filippine;Asia Orientale;Asia
58009;Ariccia;5;12;17;Moldova;Europa Centro-Orientale;Europa
58009;Ariccia;1;15;16;Messico;America Centro-Meridionale;America
58009;Ariccia;2;13;15;Colombia;America Centro-Meridionale;America
58009;Ariccia;4;8;12;Francia;Unione Europea;Europa
58009;Ariccia;2;9;11;Spagna;Unione Europea;Europa
58009;Ariccia;3;6;9;Austria;Unione Europea;Europa
58009;Ariccia;0;9;9;Kenya;Africa Orientale;Africa
58009;Ariccia;4;5;9;Stati Uniti d'America;America Settentrionale;America
58009;Ariccia;6;2;8;Guinea;Africa Occidentale;Africa
58009;Ariccia;5;3;8;Macedonia del Nord;Europa Centro-Orientale;Europa
58009;Ariccia;4;4;8;Regno Unito;Altri paesi europei;Europa
58009;Ariccia;1;6;7;Brasile;America Centro-Meridionale;America
58009;Ariccia;0;7;7;Russa, Federazione;Europa Centro-Orientale;Europa
58009;Ariccia;5;1;6;Slovacchia;Unione Europea;Europa
58009;Ariccia;4;2;6;Sri Lanka (ex Ceylon);Asia Centro-Meridionale;Asia
58009;Ariccia;1;4;5;Belgio;Unione Europea;Europa
58009;Ariccia;1;4;5;El Salvador;America Centro-Meridionale;America
58009;Ariccia;0;5;5;Lituania;Unione Europea;Europa
58009;Ariccia;3;1;4;Benin (ex Dahomey);Africa Occidentale;Africa
58009;Ariccia;4;0;4;Bosnia-Erzegovina;Europa Centro-Orientale;Europa
58009;Ariccia;1;3;4;Bulgaria;Unione Europea;Europa
58009;Ariccia;4;0;4;Costa d'Avorio;Africa Occidentale;Africa
58009;Ariccia;1;3;4;Dominicana, Repubblica;America Centro-Meridionale;America
58009;Ariccia;0;4;4;Georgia;Asia Occidentale;Asia
58009;Ariccia;3;1;4;Iran, Repubblica Islamica del;Asia Occidentale;Asia
58009;Ariccia;1;3;4;Svizzera;Altri paesi europei;Europa
58009;Ariccia;3;0;3;Algeria;Africa Settentrionale;Africa
58009;Ariccia;2;1;3;Argentina;America Centro-Meridionale;America
58009;Ariccia;2;1;3;Australia;Oceania;Oceania
58009;Ariccia;0;3;3;Bielorussia;Europa Centro-Orientale;Europa
58009;Ariccia;0;3;3;Ecuador;America Centro-Meridionale;America
58009;Ariccia;0;3;3;Guatemala;America Centro-Meridionale;America
58009;Ariccia;3;0;3;Senegal;Africa Occidentale;Africa
58009;Ariccia;3;0;3;Uruguay;America Centro-Meridionale;America
58009;Ariccia;2;1;3;Venezuela;America Centro-Meridionale;America
58009;Ariccia;1;1;2;Ceca, Repubblica;Unione Europea;Europa
58009;Ariccia;1;1;2;Cile;America Centro-Meridionale;America
58009;Ariccia;0;2;2;Congo, Repubblica democratica del (ex Zaire);Africa Centro-Meridionale;Africa
58009;Ariccia;0;2;2;Corea, Repubblica (Corea del Sud);Asia Orientale;Asia
58009;Ariccia;1;1;2;Cuba;America Centro-Meridionale;America
58009;Ariccia;0;2;2;Giappone;Asia Orientale;Asia
58009;Ariccia;0;2;2;Indonesia;Asia Orientale;Asia
58009;Ariccia;0;2;2;Madagascar;Africa Orientale;Africa
58009;Ariccia;2;0;2;Mali;Africa Occidentale;Africa
58009;Ariccia;0;2;2;Paesi Bassi;Unione Europea;Europa
58009;Ariccia;0;1;1;Armenia;Asia Occidentale;Asia
58009;Ariccia;1;0;1;Camerun;Africa Centro-Meridionale;Africa
58009;Ariccia;0;1;1;Canada;America Settentrionale;America
58009;Ariccia;0;1;1;Capo Verde;Africa Occidentale;Africa
58009;Ariccia;0;1;1;Costa Rica;America Centro-Meridionale;America
58009;Ariccia;0;1;1;Croazia;Unione Europea;Europa
58009;Ariccia;0;1;1;Dominica;America Centro-Meridionale;America
58009;Ariccia;0;1;1;Estonia;Unione Europea;Europa
58009;Ariccia;0;1;1;Etiopia;Africa Orientale;Africa
58009;Ariccia;0;1;1;Finlandia;Unione Europea;Europa
58009;Ariccia;0;1;1;Ghana;Africa Occidentale;Africa
58009;Ariccia;0;1;1;Libia;Africa Settentrionale;Africa
58009;Ariccia;0;1;1;Montenegro;Europa Centro-Orientale;Europa
58009;Ariccia;0;1;1;Panama;America Centro-Meridionale;America
58009;Ariccia;0;1;1;Paraguay;America Centro-Meridionale;America
58009;Ariccia;0;1;1;San Marino;Altri paesi europei;Europa
58009;Ariccia;0;1;1;Serbia, Repubblica di;Europa Centro-Orientale;Europa
58009;Ariccia;0;1;1;Siria;Asia Occidentale;Asia
58009;Ariccia;0;1;1;Svezia;Unione Europea;Europa
58009;Ariccia;0;1;1;Thailandia;Asia Orientale;Asia
58009;Ariccia;0;1;1;Uganda;Africa Orientale;Africa
58010;Arsoli;17;30;47;Romania;Unione Europea;Europa
58010;Arsoli;2;3;5;Albania;Europa Centro-Orientale;Europa
58010;Arsoli;2;2;4;Congo, Repubblica democratica del (ex Zaire);Africa Centro-Meridionale;Africa
58010;Arsoli;1;2;3;Congo (Repubblica del);Africa Centro-Meridionale;Africa
58010;Arsoli;2;1;3;Madagascar;Africa Orientale;Africa
58010;Arsoli;1;2;3;Spagna;Unione Europea;Europa
58010;Arsoli;1;1;2;Dominicana, Repubblica;America Centro-Meridionale;America
58010;Arsoli;1;1;2;Perù;America Centro-Meridionale;America
58010;Arsoli;0;2;2;Polonia;Unione Europea;Europa
58010;Arsoli;1;0;1;Angola;Africa Centro-Meridionale;Africa
58010;Arsoli;1;0;1;Ecuador;America Centro-Meridionale;America
58010;Arsoli;1;0;1;Egitto;Africa Settentrionale;Africa
58010;Arsoli;1;0;1;Filippine;Asia Orientale;Asia
58010;Arsoli;0;1;1;Thailandia;Asia Orientale;Asia
58010;Arsoli;0;1;1;Ucraina;Europa Centro-Orientale;Europa
58011;Artena;256;277;533;Romania;Unione Europea;Europa
58011;Artena;97;87;184;Albania;Europa Centro-Orientale;Europa
58011;Artena;32;26;58;Marocco;Africa Settentrionale;Africa
58011;Artena;22;10;32;Tunisia;Africa Settentrionale;Africa
58011;Artena;10;13;23;Cinese, Repubblica Popolare;Asia Orientale;Asia
58011;Artena;10;12;22;Moldova;Europa Centro-Orientale;Europa
58011;Artena;14;3;17;Egitto;Africa Settentrionale;Africa
58011;Artena;7;6;13;Pakistan;Asia Centro-Meridionale;Asia
58011;Artena;2;10;12;Bulgaria;Unione Europea;Europa
58011;Artena;2;8;10;Polonia;Unione Europea;Europa
58011;Artena;1;8;9;Cuba;America Centro-Meridionale;America
58011;Artena;0;9;9;Ucraina;Europa Centro-Orientale;Europa
58011;Artena;1;4;5;Filippine;Asia Orientale;Asia
58011;Artena;3;2;5;India;Asia Centro-Meridionale;Asia
58011;Artena;2;3;5;Nicaragua;America Centro-Meridionale;America
58011;Artena;2;3;5;Russa, Federazione;Europa Centro-Orientale;Europa
58011;Artena;1;3;4;Spagna;Unione Europea;Europa
58011;Artena;1;2;3;Etiopia;Africa Orientale;Africa
58011;Artena;1;2;3;Regno Unito;Altri paesi europei;Europa
58011;Artena;0;3;3;Venezuela;America Centro-Meridionale;America
58011;Artena;0;2;2;Argentina;America Centro-Meridionale;America
58011;Artena;1;1;2;Bielorussia;Europa Centro-Orientale;Europa
58011;Artena;0;2;2;Brasile;America Centro-Meridionale;America
58011;Artena;0;2;2;Dominicana, Repubblica;America Centro-Meridionale;America
58011;Artena;1;1;2;Ecuador;America Centro-Meridionale;America
58011;Artena;1;1;2;Iran, Repubblica Islamica del;Asia Occidentale;Asia
58011;Artena;2;0;2;Macedonia del Nord;Europa Centro-Orientale;Europa
58011;Artena;1;1;2;Niger;Africa Occidentale;Africa
58011;Artena;1;0;1;Angola;Africa Centro-Meridionale;Africa
58011;Artena;1;0;1;Bangladesh;Asia Centro-Meridionale;Asia
58011;Artena;0;1;1;Belgio;Unione Europea;Europa
58011;Artena;1;0;1;Bosnia-Erzegovina;Europa Centro-Orientale;Europa
58011;Artena;0;1;1;Burkina Faso (ex Alto Volta);Africa Occidentale;Africa
58011;Artena;0;1;1;Ceca, Repubblica;Unione Europea;Europa
58011;Artena;1;0;1;Francia;Unione Europea;Europa
58011;Artena;1;0;1;Gambia;Africa Occidentale;Africa
58011;Artena;0;1;1;Honduras;America Centro-Meridionale;America
58011;Artena;1;0;1;Mali;Africa Occidentale;Africa
58011;Artena;1;0;1;Nigeria;Africa Occidentale;Africa
58011;Artena;0;1;1;Perù;America Centro-Meridionale;America
58011;Artena;1;0;1;Ruanda;Africa Orientale;Africa
58011;Artena;0;1;1;Saint Vincent e Grenadine;America Centro-Meridionale;America
58011;Artena;1;0;1;Serbia, Repubblica di;Europa Centro-Orientale;Europa
58011;Artena;1;0;1;Siria;Asia Occidentale;Asia
58011;Artena;0;1;1;Stati Uniti d'America;America Settentrionale;America
58011;Artena;0;1;1;Turchia;Europa Centro-Orientale;Europa
58011;Artena;0;1;1;Ungheria;Unione Europea;Europa
58012;Bellegra;27;23;50;Romania;Unione Europea;Europa
58012;Bellegra;4;4;8;Iraq;Asia Occidentale;Asia
58012;Bellegra;2;6;8;Ucraina;Europa Centro-Orientale;Europa
58012;Bellegra;2;5;7;Polonia;Unione Europea;Europa
58012;Bellegra;4;1;5;Algeria;Africa Settentrionale;Africa
58012;Bellegra;4;1;5;Egitto;Africa Settentrionale;Africa
58012;Bellegra;1;3;4;Moldova;Europa Centro-Orientale;Europa
58012;Bellegra;2;1;3;Macedonia del Nord;Europa Centro-Orientale;Europa
58012;Bellegra;2;0;2;Stati Uniti d'America;America Settentrionale;America
58012;Bellegra;0;1;1;Austria;Unione Europea;Europa
58012;Bellegra;0;1;1;Congo (Repubblica del);Africa Centro-Meridionale;Africa
58012;Bellegra;0;1;1;Cuba;America Centro-Meridionale;America
58012;Bellegra;0;1;1;Regno Unito;Altri paesi europei;Europa
58012;Bellegra;1;0;1;Tunisia;Africa Settentrionale;Africa
58013;Bracciano;305;419;724;Romania;Unione Europea;Europa
58013;Bracciano;89;82;171;Albania;Europa Centro-Orientale;Europa
58013;Bracciano;32;78;110;Polonia;Unione Europea;Europa
58013;Bracciano;51;37;88;India;Asia Centro-Meridionale;Asia
58013;Bracciano;26;46;72;Regno Unito;Altri paesi europei;Europa
58013;Bracciano;9;52;61;Ucraina;Europa Centro-Orientale;Europa
58013;Bracciano;33;10;43;Egitto;Africa Settentrionale;Africa
58013;Bracciano;24;17;41;Cinese, Repubblica Popolare;Asia Orientale;Asia
58013;Bracciano;20;21;41;Moldova;Europa Centro-Orientale;Europa
58013;Bracciano;12;25;37;Bulgaria;Unione Europea;Europa
58013;Bracciano;17;19;36;Sri Lanka (ex Ceylon);Asia Centro-Meridionale;Asia
58013;Bracciano;19;16;35;Bangladesh;Asia Centro-Meridionale;Asia
58013;Bracciano;18;11;29;Colombia;America Centro-Meridionale;America
58013;Bracciano;10;18;28;Perù;America Centro-Meridionale;America
58013;Bracciano;7;15;22;Germania;Unione Europea;Europa
58013;Bracciano;13;9;22;Macedonia del Nord;Europa Centro-Orientale;Europa
58013;Bracciano;7;13;20;Ecuador;America Centro-Meridionale;America
58013;Bracciano;8;11;19;Stati Uniti d'America;America Settentrionale;America
58013;Bracciano;5;13;18;Filippine;Asia Orientale;Asia
58013;Bracciano;4;14;18;Francia;Unione Europea;Europa
58013;Bracciano;3;13;16;Russa, Federazione;Europa Centro-Orientale;Europa
58013;Bracciano;11;2;13;Argentina;America Centro-Meridionale;America
58013;Bracciano;3;9;12;Brasile;America Centro-Meridionale;America
58013;Bracciano;5;7;12;El Salvador;America Centro-Meridionale;America
58013;Bracciano;6;6;12;Marocco;Africa Settentrionale;Africa
58013;Bracciano;6;5;11;Kosovo;Europa Centro-Orientale;Europa
58013;Bracciano;8;3;11;Senegal;Africa Occidentale;Africa
58013;Bracciano;2;8;10;Paesi Bassi;Unione Europea;Europa
58013;Bracciano;4;5;9;Nigeria;Africa Occidentale;Africa
58013;Bracciano;3;5;8;Belgio;Unione Europea;Europa
58013;Bracciano;3;5;8;Irlanda;Unione Europea;Europa
58013;Bracciano;4;4;8;Spagna;Unione Europea;Europa
58013;Bracciano;6;2;8;Tunisia;Africa Settentrionale;Africa
58013;Bracciano;4;3;7;Sierra Leone;Africa Occidentale;Africa
58013;Bracciano;2;3;5;Guinea;Africa Occidentale;Africa
58013;Bracciano;1;4;5;Niger;Africa Occidentale;Africa
58013;Bracciano;5;0;5;Portogallo;Unione Europea;Europa
58013;Bracciano;3;2;5;Siria;Asia Occidentale;Asia
58013;Bracciano;1;4;5;Venezuela;America Centro-Meridionale;America
58013;Bracciano;3;1;4;Afghanistan;Asia Centro-Meridionale;Asia
58013;Bracciano;0;4;4;Bielorussia;Europa Centro-Orientale;Europa
58013;Bracciano;2;2;4;Congo, Repubblica democratica del (ex Zaire);Africa Centro-Meridionale;Africa
58013;Bracciano;2;2;4;Corea, Repubblica (Corea del Sud);Asia Orientale;Asia
58013;Bracciano;3;1;4;Cuba;America Centro-Meridionale;America
58013;Bracciano;0;4;4;Giappone;Asia Orientale;Asia
58013;Bracciano;2;2;4;Svezia;Unione Europea;Europa
58013;Bracciano;1;2;3;Bolivia;America Centro-Meridionale;America
58013;Bracciano;1;2;3;Danimarca;Unione Europea;Europa
58013;Bracciano;1;2;3;Dominicana, Repubblica;America Centro-Meridionale;America
58013;Bracciano;1;2;3;Eritrea;Africa Orientale;Africa
58013;Bracciano;1;2;3;Etiopia;Africa Orientale;Africa
58013;Bracciano;0;3;3;Finlandia;Unione Europea;Europa
58013;Bracciano;3;0;3;Iran, Repubblica Islamica del;Asia Occidentale;Asia
58013;Bracciano;1;2;3;Israele;Asia Occidentale;Asia
58013;Bracciano;0;3;3;Kenya;Africa Orientale;Africa
58013;Bracciano;0;3;3;Lituania;Unione Europea;Europa
58013;Bracciano;1;1;2;Austria;Unione Europea;Europa
58013;Bracciano;1;1;2;Capo Verde;Africa Occidentale;Africa
58013;Bracciano;1;1;2;Ceca, Repubblica;Unione Europea;Europa
58013;Bracciano;2;0;2;Ghana;Africa Occidentale;Africa
58013;Bracciano;1;1;2;Messico;America Centro-Meridionale;America
58013;Bracciano;1;1;2;Seychelles;Africa Orientale;Africa
58013;Bracciano;0;2;2;Thailandia;Asia Orientale;Asia
58013;Bracciano;2;0;2;Turchia;Europa Centro-Orientale;Europa
58013;Bracciano;0;2;2;Vietnam;Asia Orientale;Asia
58013;Bracciano;1;0;1;Algeria;Africa Settentrionale;Africa
58013;Bracciano;1;0;1;Apolide;;
58013;Bracciano;0;1;1;Canada;America Settentrionale;America
58013;Bracciano;1;0;1;Cile;America Centro-Meridionale;America
58013;Bracciano;1;0;1;Gambia;Africa Occidentale;Africa
58013;Bracciano;0;1;1;Georgia;Asia Occidentale;Asia
58013;Bracciano;0;1;1;Grecia;Unione Europea;Europa
58013;Bracciano;0;1;1;Guatemala;America Centro-Meridionale;America
58013;Bracciano;1;0;1;Guinea Equatoriale;Africa Centro-Meridionale;Africa
58013;Bracciano;1;0;1;Iraq;Asia Occidentale;Asia
58013;Bracciano;1;0;1;Mauritania;Africa Occidentale;Africa
58013;Bracciano;0;1;1;Nicaragua;America Centro-Meridionale;America
58013;Bracciano;0;1;1;Panama;America Centro-Meridionale;America
58013;Bracciano;1;0;1;San Marino;Altri paesi europei;Europa
58013;Bracciano;0;1;1;Serbia, Repubblica di;Europa Centro-Orientale;Europa
58013;Bracciano;0;1;1;Slovacchia;Unione Europea;Europa
58013;Bracciano;1;0;1;Somalia;Africa Orientale;Africa
58013;Bracciano;1;0;1;Sud Africa;Africa Centro-Meridionale;Africa
58013;Bracciano;0;1;1;Svizzera;Altri paesi europei;Europa
58013;Bracciano;0;1;1;Taiwan (ex Formosa);Asia Orientale;Asia
58013;Bracciano;0;1;1;Tanzania;Africa Orientale;Africa
58013;Bracciano;0;1;1;Ungheria;Unione Europea;Europa
58013;Bracciano;0;1;1;Zambia;Africa Orientale;Africa
58014;Camerata Nuova;4;5;9;Romania;Unione Europea;Europa
58014;Camerata Nuova;2;1;3;Congo, Repubblica democratica del (ex Zaire);Africa Centro-Meridionale;Africa
58014;Camerata Nuova;0;2;2;Ucraina;Europa Centro-Orientale;Europa
58014;Camerata Nuova;0;1;1;Bangladesh;Asia Centro-Meridionale;Asia
58015;Campagnano di Roma;409;456;865;Romania;Unione Europea;Europa
58015;Campagnano di Roma;84;77;161;Albania;Europa Centro-Orientale;Europa
58015;Campagnano di Roma;57;76;133;Polonia;Unione Europea;Europa
58015;Campagnano di Roma;48;38;86;Sri Lanka (ex Ceylon);Asia Centro-Meridionale;Asia
58015;Campagnano di Roma;15;41;56;Ucraina;Europa Centro-Orientale;Europa
58015;Campagnano di Roma;12;26;38;Moldova;Europa Centro-Orientale;Europa
58015;Campagnano di Roma;16;13;29;Perù;America Centro-Meridionale;America
58015;Campagnano di Roma;11;11;22;Filippine;Asia Orientale;Asia
58015;Campagnano di Roma;8;12;20;Ecuador;America Centro-Meridionale;America
58015;Campagnano di Roma;17;1;18;Bangladesh;Asia Centro-Meridionale;Asia
58015;Campagnano di Roma;11;7;18;Cinese, Repubblica Popolare;Asia Orientale;Asia
58015;Campagnano di Roma;16;2;18;Egitto;Africa Settentrionale;Africa
58015;Campagnano di Roma;6;11;17;Cuba;America Centro-Meridionale;America
58015;Campagnano di Roma;10;7;17;Marocco;Africa Settentrionale;Africa
58015;Campagnano di Roma;1;13;14;Germania;Unione Europea;Europa
58015;Campagnano di Roma;3;9;12;Regno Unito;Altri paesi europei;Europa
58015;Campagnano di Roma;11;0;11;Afghanistan;Asia Centro-Meridionale;Asia
58015;Campagnano di Roma;7;4;11;Macedonia del Nord;Europa Centro-Orientale;Europa
58015;Campagnano di Roma;5;5;10;Colombia;America Centro-Meridionale;America
58015;Campagnano di Roma;9;1;10;Pakistan;Asia Centro-Meridionale;Asia
58015;Campagnano di Roma;0;9;9;Indonesia;Asia Orientale;Asia
58015;Campagnano di Roma;2;6;8;Russa, Federazione;Europa Centro-Orientale;Europa
58015;Campagnano di Roma;0;7;7;Francia;Unione Europea;Europa
58015;Campagnano di Roma;4;3;7;Libia;Africa Settentrionale;Africa
58015;Campagnano di Roma;4;3;7;Nigeria;Africa Occidentale;Africa
58015;Campagnano di Roma;3;4;7;Stati Uniti d'America;America Settentrionale;America
58015;Campagnano di Roma;1;5;6;Brasile;America Centro-Meridionale;America
58015;Campagnano di Roma;2;3;5;Capo Verde;Africa Occidentale;Africa
58015;Campagnano di Roma;0;5;5;Spagna;Unione Europea;Europa
58015;Campagnano di Roma;2;2;4;Argentina;America Centro-Meridionale;America
58015;Campagnano di Roma;4;0;4;Costa d'Avorio;Africa Occidentale;Africa
58015;Campagnano di Roma;1;3;4;Grecia;Unione Europea;Europa
58015;Campagnano di Roma;0;3;3;El Salvador;America Centro-Meridionale;America
58015;Campagnano di Roma;0;3;3;Georgia;Asia Occidentale;Asia
58015;Campagnano di Roma;1;2;3;Guinea;Africa Occidentale;Africa
58015;Campagnano di Roma;3;0;3;India;Asia Centro-Meridionale;Asia
58015;Campagnano di Roma;1;2;3;Iran, Repubblica Islamica del;Asia Occidentale;Asia
58015;Campagnano di Roma;2;1;3;Kosovo;Europa Centro-Orientale;Europa
58015;Campagnano di Roma;2;1;3;Nepal;Asia Centro-Meridionale;Asia
58015;Campagnano di Roma;0;3;3;Paesi Bassi;Unione Europea;Europa
58015;Campagnano di Roma;3;0;3;Senegal;Africa Occidentale;Africa
58015;Campagnano di Roma;3;0;3;Tunisia;Africa Settentrionale;Africa
58015;Campagnano di Roma;0;3;3;Ungheria;Unione Europea;Europa
58015;Campagnano di Roma;1;1;2;Bielorussia;Europa Centro-Orientale;Europa
58015;Campagnano di Roma;1;1;2;Dominicana, Repubblica;America Centro-Meridionale;America
58015;Campagnano di Roma;1;1;2;Giappone;Asia Orientale;Asia
58015;Campagnano di Roma;0;2;2;Kazakhstan;Asia Centro-Meridionale;Asia
58015;Campagnano di Roma;1;1;2;Messico;America Centro-Meridionale;America
58015;Campagnano di Roma;1;1;2;Svezia;Unione Europea;Europa
58015;Campagnano di Roma;0;2;2;Thailandia;Asia Orientale;Asia
58015;Campagnano di Roma;0;1;1;Austria;Unione Europea;Europa
58015;Campagnano di Roma;1;0;1;Belgio;Unione Europea;Europa
58015;Campagnano di Roma;0;1;1;Bolivia;America Centro-Meridionale;America
58015;Campagnano di Roma;1;0;1;Bosnia-Erzegovina;Europa Centro-Orientale;Europa
58015;Campagnano di Roma;0;1;1;Bulgaria;Unione Europea;Europa
58015;Campagnano di Roma;0;1;1;Corea, Repubblica (Corea del Sud);Asia Orientale;Asia
58015;Campagnano di Roma;0;1;1;Danimarca;Unione Europea;Europa
58015;Campagnano di Roma;0;1;1;Etiopia;Africa Orientale;Africa
58015;Campagnano di Roma;1;0;1;Guatemala;America Centro-Meridionale;America
58015;Campagnano di Roma;1;0;1;Guinea Equatoriale;Africa Centro-Meridionale;Africa
58015;Campagnano di Roma;0;1;1;Irlanda;Unione Europea;Europa
58015;Campagnano di Roma;1;0;1;Israele;Asia Occidentale;Asia
58015;Campagnano di Roma;0;1;1;Lituania;Unione Europea;Europa
58015;Campagnano di Roma;0;1;1;Montenegro;Europa Centro-Orientale;Europa
58015;Campagnano di Roma;0;1;1;Norvegia;Altri paesi europei;Europa
58015;Campagnano di Roma;0;1;1;Portogallo;Unione Europea;Europa
58015;Campagnano di Roma;0;1;1;Serbia, Repubblica di;Europa Centro-Orientale;Europa
58015;Campagnano di Roma;0;1;1;Seychelles;Africa Orientale;Africa
58015;Campagnano di Roma;0;1;1;Sierra Leone;Africa Occidentale;Africa
58015;Campagnano di Roma;0;1;1;Singapore;Asia Orientale;Asia
58015;Campagnano di Roma;0;1;1;Somalia;Africa Orientale;Africa
58015;Campagnano di Roma;1;0;1;Svizzera;Altri paesi europei;Europa
58015;Campagnano di Roma;1;0;1;Venezuela;America Centro-Meridionale;America
58016;Canale Monterano;32;56;88;Romania;Unione Europea;Europa
58016;Canale Monterano;13;8;21;Sri Lanka (ex Ceylon);Asia Centro-Meridionale;Asia
58016;Canale Monterano;7;12;19;Bulgaria;Unione Europea;Europa
58016;Canale Monterano;6;11;17;Albania;Europa Centro-Orientale;Europa
58016;Canale Monterano;3;8;11;Ucraina;Europa Centro-Orientale;Europa
58016;Canale Monterano;6;2;8;India;Asia Centro-Meridionale;Asia
58016;Canale Monterano;0;8;8;Polonia;Unione Europea;Europa
58016;Canale Monterano;3;5;8;Regno Unito;Altri paesi europei;Europa
58016;Canale Monterano;4;2;6;Moldova;Europa Centro-Orientale;Europa
58016;Canale Monterano;1;4;5;Francia;Unione Europea;Europa
58016;Canale Monterano;2;2;4;Germania;Unione Europea;Europa
58016;Canale Monterano;1;3;4;Paesi Bassi;Unione Europea;Europa
58016;Canale Monterano;2;2;4;Ungheria;Unione Europea;Europa
58016;Canale Monterano;2;1;3;Lettonia;Unione Europea;Europa
58016;Canale Monterano;1;2;3;Venezuela;America Centro-Meridionale;America
58016;Canale Monterano;1;1;2;Brasile;America Centro-Meridionale;America
58016;Canale Monterano;1;1;2;Colombia;America Centro-Meridionale;America
58016;Canale Monterano;0;2;2;Ecuador;America Centro-Meridionale;America
58016;Canale Monterano;1;1;2;Georgia;Asia Occidentale;Asia
58016;Canale Monterano;1;1;2;Giappone;Asia Orientale;Asia
58016;Canale Monterano;0;2;2;Spagna;Unione Europea;Europa
58016;Canale Monterano;0;2;2;Stati Uniti d'America;America Settentrionale;America
58016;Canale Monterano;0;1;1;Australia;Oceania;Oceania
58016;Canale Monterano;1;0;1;Congo (Repubblica del);Africa Centro-Meridionale;Africa
58016;Canale Monterano;0;1;1;Corea, Repubblica (Corea del Sud);Asia Orientale;Asia
58016;Canale Monterano;0;1;1;Dominicana, Repubblica;America Centro-Meridionale;America
58016;Canale Monterano;1;0;1;Egitto;Africa Settentrionale;Africa
58016;Canale Monterano;0;1;1;Etiopia;Africa Orientale;Africa
58016;Canale Monterano;1;0;1;Filippine;Asia Orientale;Asia
58016;Canale Monterano;0;1;1;Honduras;America Centro-Meridionale;America
58016;Canale Monterano;1;0;1;Irlanda;Unione Europea;Europa
58016;Canale Monterano;1;0;1;Libano;Asia Occidentale;Asia
58016;Canale Monterano;0;1;1;Marocco;Africa Settentrionale;Africa
58016;Canale Monterano;0;1;1;Nepal;Asia Centro-Meridionale;Asia
58016;Canale Monterano;1;0;1;Perù;America Centro-Meridionale;America
58016;Canale Monterano;0;1;1;Serbia, Repubblica di;Europa Centro-Orientale;Europa
58016;Canale Monterano;0;1;1;Thailandia;Asia Orientale;Asia
58016;Canale Monterano;0;1;1;Tunisia;Africa Settentrionale;Africa
58017;Canterano;6;2;8;Egitto;Africa Settentrionale;Africa
58017;Canterano;4;2;6;Brasile;America Centro-Meridionale;America
58017;Canterano;2;4;6;Ucraina;Europa Centro-Orientale;Europa
58017;Canterano;4;1;5;Polonia;Unione Europea;Europa
58017;Canterano;3;0;3;Bangladesh;Asia Centro-Meridionale;Asia
58017;Canterano;2;1;3;Romania;Unione Europea;Europa
58017;Canterano;2;0;2;Congo, Repubblica democratica del (ex Zaire);Africa Centro-Meridionale;Africa
58017;Canterano;0;2;2;Moldova;Europa Centro-Orientale;Europa
58018;Capena;395;384;779;Romania;Unione Europea;Europa
58018;Capena;71;47;118;Albania;Europa Centro-Orientale;Europa
58018;Capena;45;29;74;Macedonia del Nord;Europa Centro-Orientale;Europa
58018;Capena;23;39;62;Polonia;Unione Europea;Europa
58018;Capena;24;30;54;Moldova;Europa Centro-Orientale;Europa
58018;Capena;34;13;47;Pakistan;Asia Centro-Meridionale;Asia
58018;Capena;19;14;33;Cinese, Repubblica Popolare;Asia Orientale;Asia
58018;Capena;28;5;33;Egitto;Africa Settentrionale;Africa
58018;Capena;12;17;29;Ucraina;Europa Centro-Orientale;Europa
58018;Capena;25;0;25;Bangladesh;Asia Centro-Meridionale;Asia
58018;Capena;11;14;25;Perù;America Centro-Meridionale;America
58018;Capena;11;11;22;Mali;Africa Occidentale;Africa
58018;Capena;12;8;20;Marocco;Africa Settentrionale;Africa
58018;Capena;6;7;13;Bulgaria;Unione Europea;Europa
58018;Capena;9;4;13;Sri Lanka (ex Ceylon);Asia Centro-Meridionale;Asia
58018;Capena;0;12;12;Russa, Federazione;Europa Centro-Orientale;Europa
58018;Capena;4;6;10;Bolivia;America Centro-Meridionale;America
58018;Capena;1;9;10;Brasile;America Centro-Meridionale;America
58018;Capena;4;5;9;Filippine;Asia Orientale;Asia
58018;Capena;3;6;9;Nigeria;Africa Occidentale;Africa
58018;Capena;7;1;8;Costa d'Avorio;Africa Occidentale;Africa
58018;Capena;5;3;8;Guinea;Africa Occidentale;Africa
58018;Capena;7;1;8;India;Asia Centro-Meridionale;Asia
58018;Capena;7;1;8;Senegal;Africa Occidentale;Africa
58018;Capena;1;6;7;Argentina;America Centro-Meridionale;America
58018;Capena;3;4;7;Ecuador;America Centro-Meridionale;America
58018;Capena;2;5;7;Francia;Unione Europea;Europa
58018;Capena;2;5;7;Spagna;Unione Europea;Europa
58018;Capena;4;2;6;Libia;Africa Settentrionale;Africa
58018;Capena;0;5;5;Cuba;America Centro-Meridionale;America
58018;Capena;3;2;5;El Salvador;America Centro-Meridionale;America
58018;Capena;1;4;5;Georgia;Asia Occidentale;Asia
58018;Capena;2;3;5;Serbia, Repubblica di;Europa Centro-Orientale;Europa
58018;Capena;3;1;4;Afghanistan;Asia Centro-Meridionale;Asia
58018;Capena;1;3;4;Ceca, Repubblica;Unione Europea;Europa
58018;Capena;3;1;4;Eritrea;Africa Orientale;Africa
58018;Capena;3;1;4;Etiopia;Africa Orientale;Africa
58018;Capena;4;0;4;Paesi Bassi;Unione Europea;Europa
58018;Capena;1;3;4;Somalia;Africa Orientale;Africa
58018;Capena;2;2;4;Tunisia;Africa Settentrionale;Africa
58018;Capena;0;3;3;Germania;Unione Europea;Europa
58018;Capena;3;0;3;Liberia;Africa Occidentale;Africa
58018;Capena;1;2;3;Regno Unito;Altri paesi europei;Europa
58018;Capena;1;1;2;Bielorussia;Europa Centro-Orientale;Europa
58018;Capena;0;2;2;Colombia;America Centro-Meridionale;America
58018;Capena;1;1;2;Dominicana, Repubblica;America Centro-Meridionale;America
58018;Capena;1;1;2;Giappone;Asia Orientale;Asia
58018;Capena;1;1;2;Mauritius;Africa Orientale;Africa
58018;Capena;1;1;2;Turchia;Europa Centro-Orientale;Europa
58018;Capena;2;0;2;Venezuela;America Centro-Meridionale;America
58018;Capena;0;1;1;Algeria;Africa Settentrionale;Africa
58018;Capena;0;1;1;Austria;Unione Europea;Europa
58018;Capena;1;0;1;Capo Verde;Africa Occidentale;Africa
58018;Capena;0;1;1;Corea, Repubblica (Corea del Sud);Asia Orientale;Asia
58018;Capena;1;0;1;Gambia;Africa Occidentale;Africa
58018;Capena;0;1;1;Guatemala;America Centro-Meridionale;America
58018;Capena;0;1;1;Iran, Repubblica Islamica del;Asia Occidentale;Asia
58018;Capena;1;0;1;Iraq;Asia Occidentale;Asia
58018;Capena;1;0;1;Irlanda;Unione Europea;Europa
58018;Capena;0;1;1;Kenya;Africa Orientale;Africa
58018;Capena;1;0;1;Kosovo;Europa Centro-Orientale;Europa
58018;Capena;0;1;1;Montenegro;Europa Centro-Orientale;Europa
58018;Capena;1;0;1;Niger;Africa Occidentale;Africa
58018;Capena;0;1;1;Paraguay;America Centro-Meridionale;America
58018;Capena;1;0;1;Sierra Leone;Africa Occidentale;Africa
58018;Capena;1;0;1;Siria;Asia Occidentale;Asia
58018;Capena;0;1;1;Stati Uniti d'America;America Settentrionale;America
58018;Capena;0;1;1;Thailandia;Asia Orientale;Asia
58018;Capena;0;1;1;Vietnam;Asia Orientale;Asia
58018;Capena;1;0;1;Yemen;Asia Occidentale;Asia
58019;Capranica Prenestina;6;7;13;Romania;Unione Europea;Europa
58019;Capranica Prenestina;9;1;10;Polonia;Unione Europea;Europa
58019;Capranica Prenestina;2;4;6;Cuba;America Centro-Meridionale;America
58019;Capranica Prenestina;1;2;3;Marocco;Africa Settentrionale;Africa
58019;Capranica Prenestina;0;1;1;Australia;Oceania;Oceania
58019;Capranica Prenestina;0;1;1;Bulgaria;Unione Europea;Europa
58019;Capranica Prenestina;1;0;1;Egitto;Africa Settentrionale;Africa
58019;Capranica Prenestina;1;0;1;Nigeria;Africa Occidentale;Africa
58020;Carpineto Romano;40;59;99;Romania;Unione Europea;Europa
58020;Carpineto Romano;6;8;14;Nigeria;Africa Occidentale;Africa
58020;Carpineto Romano;1;6;7;Bulgaria;Unione Europea;Europa
58020;Carpineto Romano;4;0;4;Colombia;America Centro-Meridionale;America
58020;Carpineto Romano;2;2;4;Congo, Repubblica democratica del (ex Zaire);Africa Centro-Meridionale;Africa
58020;Carpineto Romano;1;1;2;Albania;Europa Centro-Orientale;Europa
58020;Carpineto Romano;0;2;2;Cuba;America Centro-Meridionale;America
58020;Carpineto Romano;2;0;2;Iraq;Asia Occidentale;Asia
58020;Carpineto Romano;1;1;2;Polonia;Unione Europea;Europa
58020;Carpineto Romano;0;2;2;Tunisia;Africa Settentrionale;Africa
58020;Carpineto Romano;0;2;2;Ucraina;Europa Centro-Orientale;Europa
58020;Carpineto Romano;0;1;1;Bosnia-Erzegovina;Europa Centro-Orientale;Europa
58020;Carpineto Romano;0;1;1;Cile;America Centro-Meridionale;America
58020;Carpineto Romano;0;1;1;Cinese, Repubblica Popolare;Asia Orientale;Asia
58020;Carpineto Romano;0;1;1;Francia;Unione Europea;Europa
58020;Carpineto Romano;1;0;1;Liberia;Africa Occidentale;Africa
58020;Carpineto Romano;0;1;1;Moldova;Europa Centro-Orientale;Europa
58020;Carpineto Romano;1;0;1;Regno Unito;Altri paesi europei;Europa
58021;Casape;40;36;76;Romania;Unione Europea;Europa
58021;Casape;0;5;5;India;Asia Centro-Meridionale;Asia
58021;Casape;4;0;4;Egitto;Africa Settentrionale;Africa
58021;Casape;2;2;4;Polonia;Unione Europea;Europa
58021;Casape;0;3;3;Ucraina;Europa Centro-Orientale;Europa
58021;Casape;1;0;1;Albania;Europa Centro-Orientale;Europa
58021;Casape;1;0;1;Tunisia;Africa Settentrionale;Africa
58021;Casape;1;0;1;Turchia;Europa Centro-Orientale;Europa
58022;Castel Gandolfo;225;201;426;Romania;Unione Europea;Europa
58022;Castel Gandolfo;10;21;31;Moldova;Europa Centro-Orientale;Europa
58022;Castel Gandolfo;16;14;30;Polonia;Unione Europea;Europa
58022;Castel Gandolfo;16;11;27;Egitto;Africa Settentrionale;Africa
58022;Castel Gandolfo;6;15;21;Ucraina;Europa Centro-Orientale;Europa
58022;Castel Gandolfo;7;11;18;Turchia;Europa Centro-Orientale;Europa
58022;Castel Gandolfo;10;6;16;Albania;Europa Centro-Orientale;Europa
58022;Castel Gandolfo;5;10;15;India;Asia Centro-Meridionale;Asia
58022;Castel Gandolfo;11;4;15;Sri Lanka (ex Ceylon);Asia Centro-Meridionale;Asia
58022;Castel Gandolfo;1;12;13;Filippine;Asia Orientale;Asia
58022;Castel Gandolfo;4;7;11;Bulgaria;Unione Europea;Europa
58022;Castel Gandolfo;9;1;10;Bangladesh;Asia Centro-Meridionale;Asia
58022;Castel Gandolfo;1;9;10;Brasile;America Centro-Meridionale;America
58022;Castel Gandolfo;4;6;10;Francia;Unione Europea;Europa
58022;Castel Gandolfo;4;5;9;Cinese, Repubblica Popolare;Asia Orientale;Asia
58022;Castel Gandolfo;4;3;7;Marocco;Africa Settentrionale;Africa
58022;Castel Gandolfo;2;5;7;Pakistan;Asia Centro-Meridionale;Asia
58022;Castel Gandolfo;1;6;7;Russa, Federazione;Europa Centro-Orientale;Europa
58022;Castel Gandolfo;3;4;7;Stati Uniti d'America;America Settentrionale;America
58022;Castel Gandolfo;2;4;6;Cuba;America Centro-Meridionale;America
58022;Castel Gandolfo;1;4;5;Capo Verde;Africa Occidentale;Africa
58022;Castel Gandolfo;2;3;5;Perù;America Centro-Meridionale;America
58022;Castel Gandolfo;1;4;5;Regno Unito;Altri paesi europei;Europa
58022;Castel Gandolfo;1;4;5;Spagna;Unione Europea;Europa
58022;Castel Gandolfo;0;4;4;Australia;Oceania;Oceania
58022;Castel Gandolfo;1;3;4;Ecuador;America Centro-Meridionale;America
58022;Castel Gandolfo;0;4;4;Germania;Unione Europea;Europa
58022;Castel Gandolfo;1;3;4;Messico;America Centro-Meridionale;America
58022;Castel Gandolfo;0;4;4;Portogallo;Unione Europea;Europa
58022;Castel Gandolfo;2;2;4;Serbia, Repubblica di;Europa Centro-Orientale;Europa
58022;Castel Gandolfo;3;0;3;Benin (ex Dahomey);Africa Occidentale;Africa
58022;Castel Gandolfo;1;2;3;Grecia;Unione Europea;Europa
58022;Castel Gandolfo;0;3;3;Guatemala;America Centro-Meridionale;America
58022;Castel Gandolfo;1;2;3;Thailandia;Asia Orientale;Asia
58022;Castel Gandolfo;2;0;2;Algeria;Africa Settentrionale;Africa
58022;Castel Gandolfo;1;1;2;Burkina Faso (ex Alto Volta);Africa Occidentale;Africa
58022;Castel Gandolfo;0;2;2;Colombia;America Centro-Meridionale;America
58022;Castel Gandolfo;0;2;2;Congo (Repubblica del);Africa Centro-Meridionale;Africa
58022;Castel Gandolfo;0;2;2;Dominicana, Repubblica;America Centro-Meridionale;America
58022;Castel Gandolfo;0;2;2;Finlandia;Unione Europea;Europa
58022;Castel Gandolfo;1;1;2;Mauritania;Africa Occidentale;Africa
58022;Castel Gandolfo;0;2;2;Paesi Bassi;Unione Europea;Europa
58022;Castel Gandolfo;1;0;1;Afghanistan;Asia Centro-Meridionale;Asia
58022;Castel Gandolfo;0;1;1;Bielorussia;Europa Centro-Orientale;Europa
58022;Castel Gandolfo;1;0;1;Bosnia-Erzegovina;Europa Centro-Orientale;Europa
58022;Castel Gandolfo;0;1;1;Camerun;Africa Centro-Meridionale;Africa
58022;Castel Gandolfo;0;1;1;Ceca, Repubblica;Unione Europea;Europa
58022;Castel Gandolfo;1;0;1;Croazia;Unione Europea;Europa
58022;Castel Gandolfo;0;1;1;Danimarca;Unione Europea;Europa
58022;Castel Gandolfo;0;1;1;Georgia;Asia Occidentale;Asia
58022;Castel Gandolfo;0;1;1;Honduras;America Centro-Meridionale;America
58022;Castel Gandolfo;0;1;1;Indonesia;Asia Orientale;Asia
58022;Castel Gandolfo;1;0;1;Iran, Repubblica Islamica del;Asia Occidentale;Asia
58022;Castel Gandolfo;1;0;1;Libano;Asia Occidentale;Asia
58022;Castel Gandolfo;0;1;1;Lituania;Unione Europea;Europa
58022;Castel Gandolfo;1;0;1;Macedonia del Nord;Europa Centro-Orientale;Europa
58022;Castel Gandolfo;0;1;1;Malta;Unione Europea;Europa
58022;Castel Gandolfo;1;0;1;Mauritius;Africa Orientale;Africa
58022;Castel Gandolfo;0;1;1;Nigeria;Africa Occidentale;Africa
58022;Castel Gandolfo;0;1;1;Slovacchia;Unione Europea;Europa
58022;Castel Gandolfo;1;0;1;Slovenia;Unione Europea;Europa
58022;Castel Gandolfo;0;1;1;Svizzera;Altri paesi europei;Europa
58022;Castel Gandolfo;0;1;1;Tunisia;Africa Settentrionale;Africa
58022;Castel Gandolfo;0;1;1;Ungheria;Unione Europea;Europa
58023;Castel Madama;162;204;366;Romania;Unione Europea;Europa
58023;Castel Madama;46;27;73;Albania;Europa Centro-Orientale;Europa
58023;Castel Madama;21;4;25;Egitto;Africa Settentrionale;Africa
58023;Castel Madama;16;6;22;Bangladesh;Asia Centro-Meridionale;Asia
58023;Castel Madama;9;13;22;Polonia;Unione Europea;Europa
58023;Castel Madama;4;14;18;Ucraina;Europa Centro-Orientale;Europa
58023;Castel Madama;6;4;10;Nigeria;Africa Occidentale;Africa
58023;Castel Madama;7;2;9;Macedonia del Nord;Europa Centro-Orientale;Europa
58023;Castel Madama;3;5;8;Brasile;America Centro-Meridionale;America
58023;Castel Madama;6;0;6;India;Asia Centro-Meridionale;Asia
58023;Castel Madama;3;3;6;Marocco;Africa Settentrionale;Africa
58023;Castel Madama;5;0;5;Pakistan;Asia Centro-Meridionale;Asia
58023;Castel Madama;3;1;4;Azerbaigian;Asia Occidentale;Asia
58023;Castel Madama;1;3;4;Kosovo;Europa Centro-Orientale;Europa
58023;Castel Madama;1;2;3;Filippine;Asia Orientale;Asia
58023;Castel Madama;1;2;3;Sri Lanka (ex Ceylon);Asia Centro-Meridionale;Asia
58023;Castel Madama;1;1;2;Argentina;America Centro-Meridionale;America
58023;Castel Madama;1;1;2;Cinese, Repubblica Popolare;Asia Orientale;Asia
58023;Castel Madama;2;0;2;Iran, Repubblica Islamica del;Asia Occidentale;Asia
58023;Castel Madama;0;2;2;Moldova;Europa Centro-Orientale;Europa
58023;Castel Madama;1;1;2;Perù;America Centro-Meridionale;America
58023;Castel Madama;1;1;2;Tunisia;Africa Settentrionale;Africa
58023;Castel Madama;1;0;1;Bolivia;America Centro-Meridionale;America
58023;Castel Madama;0;1;1;Bulgaria;Unione Europea;Europa
58023;Castel Madama;1;0;1;Colombia;America Centro-Meridionale;America
58023;Castel Madama;0;1;1;Cuba;America Centro-Meridionale;America
58023;Castel Madama;1;0;1;Dominicana, Repubblica;America Centro-Meridionale;America
58023;Castel Madama;0;1;1;Etiopia;Africa Orientale;Africa
58023;Castel Madama;0;1;1;Francia;Unione Europea;Europa
58023;Castel Madama;0;1;1;Germania;Unione Europea;Europa
58023;Castel Madama;1;0;1;Israele;Asia Occidentale;Asia
58023;Castel Madama;1;0;1;Libano;Asia Occidentale;Asia
58023;Castel Madama;0;1;1;Liberia;Africa Occidentale;Africa
58023;Castel Madama;0;1;1;Panama;America Centro-Meridionale;America
58023;Castel Madama;0;1;1;Portogallo;Unione Europea;Europa
58023;Castel Madama;1;0;1;Regno Unito;Altri paesi europei;Europa
58023;Castel Madama;0;1;1;Russa, Federazione;Europa Centro-Orientale;Europa
58023;Castel Madama;1;0;1;San Marino;Altri paesi europei;Europa
58023;Castel Madama;1;0;1;Senegal;Africa Occidentale;Africa
58023;Castel Madama;1;0;1;Siria;Asia Occidentale;Asia
58023;Castel Madama;0;1;1;Spagna;Unione Europea;Europa
58023;Castel Madama;1;0;1;Stati Uniti d'America;America Settentrionale;America
58023;Castel Madama;1;0;1;Turchia;Europa Centro-Orientale;Europa
58023;Castel Madama;0;1;1;Ungheria;Unione Europea;Europa
58024;Castelnuovo di Porto;346;335;681;Romania;Unione Europea;Europa
58024;Castelnuovo di Porto;19;30;49;Moldova;Europa Centro-Orientale;Europa
58024;Castelnuovo di Porto;21;25;46;Albania;Europa Centro-Orientale;Europa
58024;Castelnuovo di Porto;13;33;46;Polonia;Unione Europea;Europa
58024;Castelnuovo di Porto;15;7;22;Pakistan;Asia Centro-Meridionale;Asia
58024;Castelnuovo di Porto;9;11;20;Nigeria;Africa Occidentale;Africa
58024;Castelnuovo di Porto;11;9;20;Sri Lanka (ex Ceylon);Asia Centro-Meridionale;Asia
58024;Castelnuovo di Porto;13;6;19;India;Asia Centro-Meridionale;Asia
58024;Castelnuovo di Porto;15;3;18;Senegal;Africa Occidentale;Africa
58024;Castelnuovo di Porto;4;14;18;Ucraina;Europa Centro-Orientale;Europa
58024;Castelnuovo di Porto;3;14;17;Brasile;America Centro-Meridionale;America
58024;Castelnuovo di Porto;13;4;17;Mali;Africa Occidentale;Africa
58024;Castelnuovo di Porto;15;0;15;Bangladesh;Asia Centro-Meridionale;Asia
58024;Castelnuovo di Porto;15;0;15;Costa d'Avorio;Africa Occidentale;Africa
58024;Castelnuovo di Porto;11;3;14;Egitto;Africa Settentrionale;Africa
58024;Castelnuovo di Porto;3;10;13;Filippine;Asia Orientale;Asia
58024;Castelnuovo di Porto;4;9;13;Perù;America Centro-Meridionale;America
58024;Castelnuovo di Porto;2;10;12;Regno Unito;Altri paesi europei;Europa
58024;Castelnuovo di Porto;1;9;10;Cuba;America Centro-Meridionale;America
58024;Castelnuovo di Porto;8;2;10;Marocco;Africa Settentrionale;Africa
58024;Castelnuovo di Porto;7;3;10;Tunisia;Africa Settentrionale;Africa
58024;Castelnuovo di Porto;4;5;9;Cinese, Repubblica Popolare;Asia Orientale;Asia
58024;Castelnuovo di Porto;7;1;8;Afghanistan;Asia Centro-Meridionale;Asia
58024;Castelnuovo di Porto;4;4;8;Francia;Unione Europea;Europa
58024;Castelnuovo di Porto;1;7;8;Portogallo;Unione Europea;Europa
58024;Castelnuovo di Porto;6;0;6;Gambia;Africa Occidentale;Africa
58024;Castelnuovo di Porto;2;4;6;Germania;Unione Europea;Europa
58024;Castelnuovo di Porto;6;0;6;Guinea;Africa Occidentale;Africa
58024;Castelnuovo di Porto;2;4;6;Macedonia del Nord;Europa Centro-Orientale;Europa
58024;Castelnuovo di Porto;2;4;6;Russa, Federazione;Europa Centro-Orientale;Europa
58024;Castelnuovo di Porto;3;1;4;Ecuador;America Centro-Meridionale;America
58024;Castelnuovo di Porto;1;3;4;Spagna;Unione Europea;Europa
58024;Castelnuovo di Porto;2;1;3;Argentina;America Centro-Meridionale;America
58024;Castelnuovo di Porto;3;0;3;Belgio;Unione Europea;Europa
58024;Castelnuovo di Porto;2;1;3;Bulgaria;Unione Europea;Europa
58024;Castelnuovo di Porto;3;0;3;Colombia;America Centro-Meridionale;America
58024;Castelnuovo di Porto;0;3;3;Giappone;Asia Orientale;Asia
58024;Castelnuovo di Porto;1;2;3;Iran, Repubblica Islamica del;Asia Occidentale;Asia
58024;Castelnuovo di Porto;2;1;3;Iraq;Asia Occidentale;Asia
58024;Castelnuovo di Porto;3;0;3;Messico;America Centro-Meridionale;America
58024;Castelnuovo di Porto;1;2;3;Serbia, Repubblica di;Europa Centro-Orientale;Europa
58024;Castelnuovo di Porto;3;0;3;Somalia;Africa Orientale;Africa
58024;Castelnuovo di Porto;1;1;2;Bielorussia;Europa Centro-Orientale;Europa
58024;Castelnuovo di Porto;1;1;2;El Salvador;America Centro-Meridionale;America
58024;Castelnuovo di Porto;1;1;2;Grecia;Unione Europea;Europa
58024;Castelnuovo di Porto;0;2;2;Honduras;America Centro-Meridionale;America
58024;Castelnuovo di Porto;1;1;2;Liberia;Africa Occidentale;Africa
58024;Castelnuovo di Porto;2;0;2;Paesi Bassi;Unione Europea;Europa
58024;Castelnuovo di Porto;0;2;2;Slovacchia;Unione Europea;Europa
58024;Castelnuovo di Porto;0;2;2;Stati Uniti d'America;America Settentrionale;America
58024;Castelnuovo di Porto;1;0;1;Apolide;;
58024;Castelnuovo di Porto;1;0;1;Australia;Oceania;Oceania
58024;Castelnuovo di Porto;1;0;1;Austria;Unione Europea;Europa
58024;Castelnuovo di Porto;1;0;1;Azerbaigian;Asia Occidentale;Asia
58024;Castelnuovo di Porto;0;1;1;Bolivia;America Centro-Meridionale;America
58024;Castelnuovo di Porto;1;0;1;Bosnia-Erzegovina;Europa Centro-Orientale;Europa
58024;Castelnuovo di Porto;1;0;1;Cipro;Unione Europea;Europa
58024;Castelnuovo di Porto;0;1;1;Danimarca;Unione Europea;Europa
58024;Castelnuovo di Porto;0;1;1;Dominicana, Repubblica;America Centro-Meridionale;America
58024;Castelnuovo di Porto;0;1;1;Georgia;Asia Occidentale;Asia
58024;Castelnuovo di Porto;1;0;1;Ghana;Africa Occidentale;Africa
58024;Castelnuovo di Porto;1;0;1;Guinea Bissau;Africa Occidentale;Africa
58024;Castelnuovo di Porto;1;0;1;Irlanda;Unione Europea;Europa
58024;Castelnuovo di Porto;1;0;1;Kazakhstan;Asia Centro-Meridionale;Asia
58024;Castelnuovo di Porto;1;0;1;Kosovo;Europa Centro-Orientale;Europa
58024;Castelnuovo di Porto;1;0;1;Lettonia;Unione Europea;Europa
58024;Castelnuovo di Porto;0;1;1;Sud Africa;Africa Centro-Meridionale;Africa
58024;Castelnuovo di Porto;0;1;1;Svezia;Unione Europea;Europa
58024;Castelnuovo di Porto;1;0;1;Territori dell'Autonomia Palestinese;Asia Occidentale;Asia
58024;Castelnuovo di Porto;1;0;1;Turchia;Europa Centro-Orientale;Europa
58024;Castelnuovo di Porto;0;1;1;Venezuela;America Centro-Meridionale;America
58025;Castel San Pietro Romano;13;14;27;Romania;Unione Europea;Europa
58025;Castel San Pietro Romano;6;2;8;Marocco;Africa Settentrionale;Africa
58025;Castel San Pietro Romano;1;2;3;Bangladesh;Asia Centro-Meridionale;Asia
58025;Castel San Pietro Romano;2;1;3;Guatemala;America Centro-Meridionale;America
58025;Castel San Pietro Romano;2;1;3;Macedonia del Nord;Europa Centro-Orientale;Europa
58025;Castel San Pietro Romano;1;1;2;Albania;Europa Centro-Orientale;Europa
58025;Castel San Pietro Romano;1;1;2;Cuba;America Centro-Meridionale;America
58025;Castel San Pietro Romano;1;1;2;Polonia;Unione Europea;Europa
58025;Castel San Pietro Romano;0;2;2;Ucraina;Europa Centro-Orientale;Europa
58025;Castel San Pietro Romano;0;1;1;Bulgaria;Unione Europea;Europa
58025;Castel San Pietro Romano;0;1;1;Filippine;Asia Orientale;Asia
58025;Castel San Pietro Romano;0;1;1;Moldova;Europa Centro-Orientale;Europa
58026;Cave;271;285;556;Romania;Unione Europea;Europa
58026;Cave;105;77;182;Nigeria;Africa Occidentale;Africa
58026;Cave;45;36;81;Albania;Europa Centro-Orientale;Europa
58026;Cave;24;14;38;Bangladesh;Asia Centro-Meridionale;Asia
58026;Cave;12;26;38;Ucraina;Europa Centro-Orientale;Europa
58026;Cave;24;13;37;Marocco;Africa Settentrionale;Africa
58026;Cave;7;19;26;Polonia;Unione Europea;Europa
58026;Cave;9;10;19;Bulgaria;Unione Europea;Europa
58026;Cave;12;7;19;Iraq;Asia Occidentale;Asia
58026;Cave;6;8;14;Moldova;Europa Centro-Orientale;Europa
58026;Cave;11;2;13;Egitto;Africa Settentrionale;Africa
58026;Cave;4;4;8;Cinese, Repubblica Popolare;Asia Orientale;Asia
58026;Cave;1;6;7;Cuba;America Centro-Meridionale;America
58026;Cave;5;2;7;Macedonia del Nord;Europa Centro-Orientale;Europa
58026;Cave;2;5;7;Perù;America Centro-Meridionale;America
58026;Cave;1;5;6;Filippine;Asia Orientale;Asia
58026;Cave;4;2;6;Pakistan;Asia Centro-Meridionale;Asia
58026;Cave;3;3;6;Tunisia;Africa Settentrionale;Africa
58026;Cave;2;3;5;Camerun;Africa Centro-Meridionale;Africa
58026;Cave;3;2;5;Kosovo;Europa Centro-Orientale;Europa
58026;Cave;0;5;5;Messico;America Centro-Meridionale;America
58026;Cave;2;3;5;Sri Lanka (ex Ceylon);Asia Centro-Meridionale;Asia
58026;Cave;3;1;4;Argentina;America Centro-Meridionale;America
58026;Cave;2;2;4;Ecuador;America Centro-Meridionale;America
58026;Cave;3;1;4;Germania;Unione Europea;Europa
58026;Cave;2;2;4;India;Asia Centro-Meridionale;Asia
58026;Cave;2;2;4;Portogallo;Unione Europea;Europa
58026;Cave;0;3;3;Bielorussia;Europa Centro-Orientale;Europa
58026;Cave;1;2;3;Colombia;America Centro-Meridionale;America
58026;Cave;1;2;3;Grecia;Unione Europea;Europa
58026;Cave;1;2;3;Russa, Federazione;Europa Centro-Orientale;Europa
58026;Cave;2;1;3;Slovacchia;Unione Europea;Europa
58026;Cave;3;0;3;Venezuela;America Centro-Meridionale;America
58026;Cave;2;0;2;Capo Verde;Africa Occidentale;Africa
58026;Cave;1;1;2;Georgia;Asia Occidentale;Asia
58026;Cave;0;2;2;Spagna;Unione Europea;Europa
58026;Cave;0;1;1;Austria;Unione Europea;Europa
58026;Cave;1;0;1;Congo, Repubblica democratica del (ex Zaire);Africa Centro-Meridionale;Africa
58026;Cave;0;1;1;Costa d'Avorio;Africa Occidentale;Africa
58026;Cave;0;1;1;Croazia;Unione Europea;Europa
58026;Cave;1;0;1;Dominicana, Repubblica;America Centro-Meridionale;America
58026;Cave;0;1;1;Eritrea;Africa Orientale;Africa
58026;Cave;0;1;1;Francia;Unione Europea;Europa
58026;Cave;0;1;1;Kenya;Africa Orientale;Africa
58026;Cave;0;1;1;Lettonia;Unione Europea;Europa
58026;Cave;0;1;1;Libano;Asia Occidentale;Asia
58026;Cave;0;1;1;Lituania;Unione Europea;Europa
58026;Cave;0;1;1;Malta;Unione Europea;Europa
58026;Cave;1;0;1;Norvegia;Altri paesi europei;Europa
58026;Cave;0;1;1;Paesi Bassi;Unione Europea;Europa
58026;Cave;1;0;1;Senegal;Africa Occidentale;Africa
58026;Cave;1;0;1;Somalia;Africa Orientale;Africa
58026;Cave;1;0;1;Svezia;Unione Europea;Europa
58026;Cave;1;0;1;Tanzania;Africa Orientale;Africa
58026;Cave;1;0;1;Territori dell'Autonomia Palestinese;Asia Occidentale;Asia
58026;Cave;0;1;1;Thailandia;Asia Orientale;Asia
58026;Cave;1;0;1;Togo;Africa Occidentale;Africa
58027;Cerreto Laziale;30;39;69;Romania;Unione Europea;Europa
58027;Cerreto Laziale;0;5;5;Moldova;Europa Centro-Orientale;Europa
58027;Cerreto Laziale;0;4;4;Ucraina;Europa Centro-Orientale;Europa
58027;Cerreto Laziale;2;1;3;Albania;Europa Centro-Orientale;Europa
58027;Cerreto Laziale;1;2;3;Marocco;Africa Settentrionale;Africa
58027;Cerreto Laziale;0;3;3;Polonia;Unione Europea;Europa
58027;Cerreto Laziale;0;2;2;Brasile;America Centro-Meridionale;America
58027;Cerreto Laziale;2;0;2;Tanzania;Africa Orientale;Africa
58027;Cerreto Laziale;1;0;1;Bangladesh;Asia Centro-Meridionale;Asia
58027;Cerreto Laziale;0;1;1;Finlandia;Unione Europea;Europa
58027;Cerreto Laziale;1;0;1;Madagascar;Africa Orientale;Africa
58027;Cerreto Laziale;0;1;1;Perù;America Centro-Meridionale;America
58027;Cerreto Laziale;1;0;1;Tunisia;Africa Settentrionale;Africa
58028;Cervara di Roma;16;12;28;Romania;Unione Europea;Europa
58028;Cervara di Roma;2;3;5;Ucraina;Europa Centro-Orientale;Europa
58028;Cervara di Roma;1;2;3;Albania;Europa Centro-Orientale;Europa
58028;Cervara di Roma;1;2;3;Cinese, Repubblica Popolare;Asia Orientale;Asia
58028;Cervara di Roma;2;0;2;Macedonia del Nord;Europa Centro-Orientale;Europa
58028;Cervara di Roma;0;2;2;Nicaragua;America Centro-Meridionale;America
58028;Cervara di Roma;0;1;1;Cuba;America Centro-Meridionale;America
58028;Cervara di Roma;1;0;1;Grecia;Unione Europea;Europa
58029;Cerveteri;730;881;1611;Romania;Unione Europea;Europa
58029;Cerveteri;49;138;187;Polonia;Unione Europea;Europa
58029;Cerveteri;85;29;114;India;Asia Centro-Meridionale;Asia
58029;Cerveteri;66;43;109;Marocco;Africa Settentrionale;Africa
58029;Cerveteri;42;54;96;Bulgaria;Unione Europea;Europa
58029;Cerveteri;21;71;92;Ucraina;Europa Centro-Orientale;Europa
58029;Cerveteri;29;35;64;Cinese, Repubblica Popolare;Asia Orientale;Asia
58029;Cerveteri;52;11;63;Egitto;Africa Settentrionale;Africa
58029;Cerveteri;35;15;50;Senegal;Africa Occidentale;Africa
58029;Cerveteri;12;29;41;Moldova;Europa Centro-Orientale;Europa
58029;Cerveteri;6;26;32;Brasile;America Centro-Meridionale;America
58029;Cerveteri;7;25;32;Russa, Federazione;Europa Centro-Orientale;Europa
58029;Cerveteri;24;6;30;Bangladesh;Asia Centro-Meridionale;Asia
58029;Cerveteri;10;20;30;Cuba;America Centro-Meridionale;America
58029;Cerveteri;14;15;29;Macedonia del Nord;Europa Centro-Orientale;Europa
58029;Cerveteri;10;18;28;Albania;Europa Centro-Orientale;Europa
58029;Cerveteri;3;25;28;Regno Unito;Altri paesi europei;Europa
58029;Cerveteri;8;19;27;Francia;Unione Europea;Europa
58029;Cerveteri;7;20;27;Germania;Unione Europea;Europa
58029;Cerveteri;12;11;23;Tunisia;Africa Settentrionale;Africa
58029;Cerveteri;7;15;22;Colombia;America Centro-Meridionale;America
58029;Cerveteri;7;14;21;Perù;America Centro-Meridionale;America
58029;Cerveteri;6;13;19;Ecuador;America Centro-Meridionale;America
58029;Cerveteri;6;13;19;Venezuela;America Centro-Meridionale;America
58029;Cerveteri;3;14;17;Filippine;Asia Orientale;Asia
58029;Cerveteri;3;14;17;Spagna;Unione Europea;Europa
58029;Cerveteri;10;6;16;Libano;Asia Occidentale;Asia
58029;Cerveteri;8;8;16;Nigeria;Africa Occidentale;Africa
58029;Cerveteri;6;9;15;Argentina;America Centro-Meridionale;America
58029;Cerveteri;7;8;15;Stati Uniti d'America;America Settentrionale;America
58029;Cerveteri;9;5;14;Kosovo;Europa Centro-Orientale;Europa
58029;Cerveteri;9;4;13;Mauritius;Africa Orientale;Africa
58029;Cerveteri;1;11;12;Paesi Bassi;Unione Europea;Europa
58029;Cerveteri;6;5;11;Pakistan;Asia Centro-Meridionale;Asia
58029;Cerveteri;6;2;8;Algeria;Africa Settentrionale;Africa
58029;Cerveteri;1;7;8;Giappone;Asia Orientale;Asia
58029;Cerveteri;2;5;7;Etiopia;Africa Orientale;Africa
58029;Cerveteri;5;2;7;Guinea;Africa Occidentale;Africa
58029;Cerveteri;4;3;7;Portogallo;Unione Europea;Europa
58029;Cerveteri;3;3;6;Sri Lanka (ex Ceylon);Asia Centro-Meridionale;Asia
58029;Cerveteri;3;2;5;Belgio;Unione Europea;Europa
58029;Cerveteri;3;2;5;Svizzera;Altri paesi europei;Europa
58029;Cerveteri;4;0;4;Afghanistan;Asia Centro-Meridionale;Asia
58029;Cerveteri;1;3;4;Costa d'Avorio;Africa Occidentale;Africa
58029;Cerveteri;0;4;4;Croazia;Unione Europea;Europa
58029;Cerveteri;1;3;4;Lettonia;Unione Europea;Europa
58029;Cerveteri;1;3;4;Slovacchia;Unione Europea;Europa
58029;Cerveteri;0;4;4;Svezia;Unione Europea;Europa
58029;Cerveteri;0;4;4;Thailandia;Asia Orientale;Asia
58029;Cerveteri;4;0;4;Turchia;Europa Centro-Orientale;Europa
58029;Cerveteri;0;3;3;Austria;Unione Europea;Europa
58029;Cerveteri;0;3;3;Ceca, Repubblica;Unione Europea;Europa
58029;Cerveteri;2;1;3;Dominicana, Repubblica;America Centro-Meridionale;America
58029;Cerveteri;0;3;3;Finlandia;Unione Europea;Europa
58029;Cerveteri;2;1;3;Iran, Repubblica Islamica del;Asia Occidentale;Asia
58029;Cerveteri;1;2;3;Kazakhstan;Asia Centro-Meridionale;Asia
58029;Cerveteri;2;1;3;Norvegia;Altri paesi europei;Europa
58029;Cerveteri;2;1;3;Tanzania;Africa Orientale;Africa
58029;Cerveteri;0;3;3;Ungheria;Unione Europea;Europa
58029;Cerveteri;0;2;2;Bielorussia;Europa Centro-Orientale;Europa
58029;Cerveteri;1;1;2;Camerun;Africa Centro-Meridionale;Africa
58029;Cerveteri;0;2;2;Canada;America Settentrionale;America
58029;Cerveteri;0;2;2;Capo Verde;Africa Occidentale;Africa
58029;Cerveteri;0;2;2;Cile;America Centro-Meridionale;America
58029;Cerveteri;0;2;2;Danimarca;Unione Europea;Europa
58029;Cerveteri;0;2;2;Georgia;Asia Occidentale;Asia
58029;Cerveteri;0;2;2;Honduras;America Centro-Meridionale;America
58029;Cerveteri;0;2;2;Irlanda;Unione Europea;Europa
58029;Cerveteri;1;1;2;Kenya;Africa Orientale;Africa
58029;Cerveteri;2;0;2;Liberia;Africa Occidentale;Africa
58029;Cerveteri;2;0;2;Mauritania;Africa Occidentale;Africa
58029;Cerveteri;0;2;2;Messico;America Centro-Meridionale;America
58029;Cerveteri;1;0;1;Arabia Saudita;Asia Occidentale;Asia
58029;Cerveteri;0;1;1;Armenia;Asia Occidentale;Asia
58029;Cerveteri;0;1;1;Australia;Oceania;Oceania
58029;Cerveteri;1;0;1;Benin (ex Dahomey);Africa Occidentale;Africa
58029;Cerveteri;1;0;1;Burundi;Africa Orientale;Africa
58029;Cerveteri;0;1;1;Cipro;Unione Europea;Europa
58029;Cerveteri;1;0;1;Congo, Repubblica democratica del (ex Zaire);Africa Centro-Meridionale;Africa
58029;Cerveteri;0;1;1;Eritrea;Africa Orientale;Africa
58029;Cerveteri;0;1;1;Estonia;Unione Europea;Europa
58029;Cerveteri;1;0;1;Ghana;Africa Occidentale;Africa
58029;Cerveteri;1;0;1;Mali;Africa Occidentale;Africa
58029;Cerveteri;0;1;1;Montenegro;Europa Centro-Orientale;Europa
58029;Cerveteri;0;1;1;Panama;America Centro-Meridionale;America
58029;Cerveteri;1;0;1;San Marino;Altri paesi europei;Europa
58029;Cerveteri;0;1;1;Serbia, Repubblica di;Europa Centro-Orientale;Europa
58029;Cerveteri;0;1;1;Slovenia;Unione Europea;Europa
58029;Cerveteri;0;1;1;Somalia;Africa Orientale;Africa
58029;Cerveteri;0;1;1;Uzbekistan;Asia Centro-Meridionale;Asia
58118;Ciampino;591;773;1364;Romania;Unione Europea;Europa
58118;Ciampino;105;109;214;Albania;Europa Centro-Orientale;Europa
58118;Ciampino;42;67;109;Moldova;Europa Centro-Orientale;Europa
58118;Ciampino;25;84;109;Ucraina;Europa Centro-Orientale;Europa
58118;Ciampino;76;32;108;Egitto;Africa Settentrionale;Africa
58118;Ciampino;48;49;97;Cinese, Repubblica Popolare;Asia Orientale;Asia
58118;Ciampino;62;32;94;Bangladesh;Asia Centro-Meridionale;Asia
58118;Ciampino;29;37;66;Filippine;Asia Orientale;Asia
58118;Ciampino;10;37;47;Polonia;Unione Europea;Europa
58118;Ciampino;15;21;36;Perù;America Centro-Meridionale;America
58118;Ciampino;14;19;33;Bulgaria;Unione Europea;Europa
58118;Ciampino;19;14;33;Marocco;Africa Settentrionale;Africa
58118;Ciampino;9;22;31;Cuba;America Centro-Meridionale;America
58118;Ciampino;20;9;29;India;Asia Centro-Meridionale;Asia
58118;Ciampino;20;6;26;Turchia;Europa Centro-Orientale;Europa
58118;Ciampino;4;21;25;Georgia;Asia Occidentale;Asia
58118;Ciampino;8;14;22;Brasile;America Centro-Meridionale;America
58118;Ciampino;7;15;22;Colombia;America Centro-Meridionale;America
58118;Ciampino;19;2;21;Senegal;Africa Occidentale;Africa
58118;Ciampino;8;12;20;Spagna;Unione Europea;Europa
58118;Ciampino;11;7;18;Madagascar;Africa Orientale;Africa
58118;Ciampino;7;11;18;Siria;Asia Occidentale;Asia
58118;Ciampino;11;6;17;Afghanistan;Asia Centro-Meridionale;Asia
58118;Ciampino;6;11;17;Francia;Unione Europea;Europa
58118;Ciampino;0;17;17;Russa, Federazione;Europa Centro-Orientale;Europa
58118;Ciampino;9;7;16;Sri Lanka (ex Ceylon);Asia Centro-Meridionale;Asia
58118;Ciampino;9;7;16;Tunisia;Africa Settentrionale;Africa
58118;Ciampino;5;10;15;Ecuador;America Centro-Meridionale;America
58118;Ciampino;11;4;15;Ghana;Africa Occidentale;Africa
58118;Ciampino;4;11;15;Honduras;America Centro-Meridionale;America
58118;Ciampino;5;7;12;Bolivia;America Centro-Meridionale;America
58118;Ciampino;4;8;12;Regno Unito;Altri paesi europei;Europa
58118;Ciampino;7;4;11;Nigeria;Africa Occidentale;Africa
58118;Ciampino;4;4;8;Corea, Repubblica (Corea del Sud);Asia Orientale;Asia
58118;Ciampino;3;5;8;Germania;Unione Europea;Europa
58118;Ciampino;3;5;8;Stati Uniti d'America;America Settentrionale;America
58118;Ciampino;3;4;7;Bosnia-Erzegovina;Europa Centro-Orientale;Europa
58118;Ciampino;2;5;7;Capo Verde;Africa Occidentale;Africa
58118;Ciampino;3;4;7;Croazia;Unione Europea;Europa
58118;Ciampino;5;2;7;Kosovo;Europa Centro-Orientale;Europa
58118;Ciampino;5;2;7;Pakistan;Asia Centro-Meridionale;Asia
58118;Ciampino;2;4;6;Congo (Repubblica del);Africa Centro-Meridionale;Africa
58118;Ciampino;3;3;6;San Marino;Altri paesi europei;Europa
58118;Ciampino;0;5;5;Dominicana, Repubblica;America Centro-Meridionale;America
58118;Ciampino;0;5;5;El Salvador;America Centro-Meridionale;America
58118;Ciampino;0;5;5;Giappone;Asia Orientale;Asia
58118;Ciampino;5;0;5;Mali;Africa Occidentale;Africa
58118;Ciampino;1;4;5;Slovacchia;Unione Europea;Europa
58118;Ciampino;2;3;5;Togo;Africa Occidentale;Africa
58118;Ciampino;0;5;5;Venezuela;America Centro-Meridionale;America
58118;Ciampino;1;3;4;Bielorussia;Europa Centro-Orientale;Europa
58118;Ciampino;4;0;4;Gambia;Africa Occidentale;Africa
58118;Ciampino;0;4;4;Indonesia;Asia Orientale;Asia
58118;Ciampino;2;2;4;Iran, Repubblica Islamica del;Asia Occidentale;Asia
58118;Ciampino;2;2;4;Iraq;Asia Occidentale;Asia
58118;Ciampino;2;2;4;Liberia;Africa Occidentale;Africa
58118;Ciampino;2;2;4;Macedonia del Nord;Europa Centro-Orientale;Europa
58118;Ciampino;3;1;4;Uzbekistan;Asia Centro-Meridionale;Asia
58118;Ciampino;3;0;3;Algeria;Africa Settentrionale;Africa
58118;Ciampino;3;0;3;Benin (ex Dahomey);Africa Occidentale;Africa
58118;Ciampino;1;2;3;Etiopia;Africa Orientale;Africa
58118;Ciampino;3;0;3;Giordania;Asia Occidentale;Asia
58118;Ciampino;2;1;3;Portogallo;Unione Europea;Europa
58118;Ciampino;0;3;3;Svezia;Unione Europea;Europa
58118;Ciampino;1;2;3;Ungheria;Unione Europea;Europa
58118;Ciampino;1;1;2;Argentina;America Centro-Meridionale;America
58118;Ciampino;1;1;2;Austria;Unione Europea;Europa
58118;Ciampino;2;0;2;Camerun;Africa Centro-Meridionale;Africa
58118;Ciampino;2;0;2;Ceca, Repubblica;Unione Europea;Europa
58118;Ciampino;0;2;2;Costa d'Avorio;Africa Occidentale;Africa
58118;Ciampino;1;1;2;Gabon;Africa Centro-Meridionale;Africa
58118;Ciampino;0;2;2;Grecia;Unione Europea;Europa
58118;Ciampino;1;1;2;Kenya;Africa Orientale;Africa
58118;Ciampino;1;1;2;Paesi Bassi;Unione Europea;Europa
58118;Ciampino;0;2;2;Serbia, Repubblica di;Europa Centro-Orientale;Europa
58118;Ciampino;2;0;2;Somalia;Africa Orientale;Africa
58118;Ciampino;1;1;2;Zimbabwe (ex Rhodesia);Africa Orientale;Africa
58118;Ciampino;0;1;1;Armenia;Asia Occidentale;Asia
58118;Ciampino;0;1;1;Belgio;Unione Europea;Europa
58118;Ciampino;1;0;1;Cile;America Centro-Meridionale;America
58118;Ciampino;0;1;1;Congo, Repubblica democratica del (ex Zaire);Africa Centro-Meridionale;Africa
58118;Ciampino;0;1;1;Finlandia;Unione Europea;Europa
58118;Ciampino;0;1;1;Guatemala;America Centro-Meridionale;America
58118;Ciampino;1;0;1;Guinea;Africa Occidentale;Africa
58118;Ciampino;1;0;1;Israele;Asia Occidentale;Asia
58118;Ciampino;0;1;1;Kazakhstan;Asia Centro-Meridionale;Asia
58118;Ciampino;0;1;1;Mauritius;Africa Orientale;Africa
58118;Ciampino;0;1;1;Messico;America Centro-Meridionale;America
58118;Ciampino;0;1;1;Norvegia;Altri paesi europei;Europa
58118;Ciampino;0;1;1;Ruanda;Africa Orientale;Africa
58118;Ciampino;0;1;1;Sierra Leone;Africa Occidentale;Africa
58118;Ciampino;0;1;1;Sud Africa;Africa Centro-Meridionale;Africa
58118;Ciampino;0;1;1;Svizzera;Altri paesi europei;Europa
58118;Ciampino;1;0;1;Territori dell'Autonomia Palestinese;Asia Occidentale;Asia
58118;Ciampino;0;1;1;Thailandia;Asia Orientale;Asia
58118;Ciampino;1;0;1;Uganda;Africa Orientale;Africa
58030;Ciciliano;31;34;65;Romania;Unione Europea;Europa
58030;Ciciliano;6;2;8;Albania;Europa Centro-Orientale;Europa
58030;Ciciliano;1;2;3;Polonia;Unione Europea;Europa
58030;Ciciliano;1;2;3;Somalia;Africa Orientale;Africa
58030;Ciciliano;2;1;3;Sri Lanka (ex Ceylon);Asia Centro-Meridionale;Asia
58030;Ciciliano;0;3;3;Ucraina;Europa Centro-Orientale;Europa
58030;Ciciliano;1;1;2;Congo, Repubblica democratica del (ex Zaire);Africa Centro-Meridionale;Africa
58030;Ciciliano;1;1;2;Pakistan;Asia Centro-Meridionale;Asia
58030;Ciciliano;0;2;2;Zimbabwe (ex Rhodesia);Africa Orientale;Africa
58030;Ciciliano;0;1;1;Algeria;Africa Settentrionale;Africa
58030;Ciciliano;1;0;1;Iraq;Asia Occidentale;Asia
58030;Ciciliano;1;0;1;Marocco;Africa Settentrionale;Africa
58030;Ciciliano;0;1;1;Ruanda;Africa Orientale;Africa
58030;Ciciliano;0;1;1;Russa, Federazione;Europa Centro-Orientale;Europa
58030;Ciciliano;1;0;1;Senegal;Africa Occidentale;Africa
58030;Ciciliano;0;1;1;Tanzania;Africa Orientale;Africa
58031;Cineto Romano;14;24;38;Romania;Unione Europea;Europa
58031;Cineto Romano;1;3;4;Polonia;Unione Europea;Europa
58031;Cineto Romano;1;1;2;Albania;Europa Centro-Orientale;Europa
58031;Cineto Romano;2;0;2;El Salvador;America Centro-Meridionale;America
58031;Cineto Romano;1;1;2;Moldova;Europa Centro-Orientale;Europa
58031;Cineto Romano;1;1;2;Ucraina;Europa Centro-Orientale;Europa
58031;Cineto Romano;0;1;1;Cinese, Repubblica Popolare;Asia Orientale;Asia
58031;Cineto Romano;0;1;1;Paraguay;America Centro-Meridionale;America
58031;Cineto Romano;0;1;1;Perù;America Centro-Meridionale;America
58031;Cineto Romano;0;1;1;Somalia;Africa Orientale;Africa
58031;Cineto Romano;1;0;1;Stati Uniti d'America;America Settentrionale;America
58032;Civitavecchia;718;942;1660;Romania;Unione Europea;Europa
58032;Civitavecchia;83;80;163;Cinese, Repubblica Popolare;Asia Orientale;Asia
58032;Civitavecchia;122;26;148;Bangladesh;Asia Centro-Meridionale;Asia
58032;Civitavecchia;46;40;86;Albania;Europa Centro-Orientale;Europa
58032;Civitavecchia;39;31;70;Marocco;Africa Settentrionale;Africa
58032;Civitavecchia;48;10;58;Egitto;Africa Settentrionale;Africa
58032;Civitavecchia;41;14;55;Senegal;Africa Occidentale;Africa
58032;Civitavecchia;8;35;43;Ucraina;Europa Centro-Orientale;Europa
58032;Civitavecchia;12;29;41;Polonia;Unione Europea;Europa
58032;Civitavecchia;24;8;32;Nigeria;Africa Occidentale;Africa
58032;Civitavecchia;22;9;31;Pakistan;Asia Centro-Meridionale;Asia
58032;Civitavecchia;13;17;30;Filippine;Asia Orientale;Asia
58032;Civitavecchia;2;27;29;Brasile;America Centro-Meridionale;America
58032;Civitavecchia;19;7;26;Tunisia;Africa Settentrionale;Africa
58032;Civitavecchia;18;6;24;India;Asia Centro-Meridionale;Asia
58032;Civitavecchia;5;17;22;Bulgaria;Unione Europea;Europa
58032;Civitavecchia;4;18;22;Russa, Federazione;Europa Centro-Orientale;Europa
58032;Civitavecchia;9;11;20;Venezuela;America Centro-Meridionale;America
58032;Civitavecchia;5;14;19;Cuba;America Centro-Meridionale;America
58032;Civitavecchia;5;11;16;Spagna;Unione Europea;Europa
58032;Civitavecchia;2;13;15;Ecuador;America Centro-Meridionale;America
58032;Civitavecchia;4;10;14;Bielorussia;Europa Centro-Orientale;Europa
58032;Civitavecchia;4;10;14;Germania;Unione Europea;Europa
58032;Civitavecchia;13;1;14;Iraq;Asia Occidentale;Asia
58032;Civitavecchia;4;10;14;Moldova;Europa Centro-Orientale;Europa
58032;Civitavecchia;2;11;13;Colombia;America Centro-Meridionale;America
58032;Civitavecchia;6;5;11;Perù;America Centro-Meridionale;America
58032;Civitavecchia;5;6;11;Turchia;Europa Centro-Orientale;Europa
58032;Civitavecchia;5;5;10;Etiopia;Africa Orientale;Africa
58032;Civitavecchia;3;5;8;Francia;Unione Europea;Europa
58032;Civitavecchia;2;6;8;Thailandia;Asia Orientale;Asia
58032;Civitavecchia;6;1;7;Argentina;America Centro-Meridionale;America
58032;Civitavecchia;4;3;7;Ceca, Repubblica;Unione Europea;Europa
58032;Civitavecchia;1;6;7;Cile;America Centro-Meridionale;America
58032;Civitavecchia;6;0;6;Afghanistan;Asia Centro-Meridionale;Asia
58032;Civitavecchia;3;3;6;Algeria;Africa Settentrionale;Africa
58032;Civitavecchia;3;3;6;Dominicana, Repubblica;America Centro-Meridionale;America
58032;Civitavecchia;5;1;6;Eritrea;Africa Orientale;Africa
58032;Civitavecchia;3;3;6;Regno Unito;Altri paesi europei;Europa
58032;Civitavecchia;2;3;5;Libia;Africa Settentrionale;Africa
58032;Civitavecchia;4;1;5;San Marino;Altri paesi europei;Europa
58032;Civitavecchia;1;4;5;Uruguay;America Centro-Meridionale;America
58032;Civitavecchia;0;4;4;Congo (Repubblica del);Africa Centro-Meridionale;Africa
58032;Civitavecchia;0;4;4;Croazia;Unione Europea;Europa
58032;Civitavecchia;2;2;4;Indonesia;Asia Orientale;Asia
58032;Civitavecchia;1;3;4;Iran, Repubblica Islamica del;Asia Occidentale;Asia
58032;Civitavecchia;3;1;4;Serbia, Repubblica di;Europa Centro-Orientale;Europa
58032;Civitavecchia;1;2;3;Bolivia;America Centro-Meridionale;America
58032;Civitavecchia;1;2;3;Camerun;Africa Centro-Meridionale;Africa
58032;Civitavecchia;2;1;3;Capo Verde;Africa Occidentale;Africa
58032;Civitavecchia;0;3;3;Costa d'Avorio;Africa Occidentale;Africa
58032;Civitavecchia;0;3;3;Giappone;Asia Orientale;Asia
58032;Civitavecchia;0;3;3;Grecia;Unione Europea;Europa
58032;Civitavecchia;1;2;3;Messico;America Centro-Meridionale;America
58032;Civitavecchia;2;0;2;Burundi;Africa Orientale;Africa
58032;Civitavecchia;1;1;2;El Salvador;America Centro-Meridionale;America
58032;Civitavecchia;2;0;2;Gambia;Africa Occidentale;Africa
58032;Civitavecchia;0;2;2;Libano;Asia Occidentale;Asia
58032;Civitavecchia;2;0;2;Mali;Africa Occidentale;Africa
58032;Civitavecchia;2;0;2;Somalia;Africa Orientale;Africa
58032;Civitavecchia;1;1;2;Sri Lanka (ex Ceylon);Asia Centro-Meridionale;Asia
58032;Civitavecchia;1;1;2;Stati Uniti d'America;America Settentrionale;America
58032;Civitavecchia;2;0;2;Togo;Africa Occidentale;Africa
58032;Civitavecchia;0;2;2;Ungheria;Unione Europea;Europa
58032;Civitavecchia;0;2;2;Uzbekistan;Asia Centro-Meridionale;Asia
58032;Civitavecchia;0;1;1;Angola;Africa Centro-Meridionale;Africa
58032;Civitavecchia;1;0;1;Australia;Oceania;Oceania
58032;Civitavecchia;0;1;1;Austria;Unione Europea;Europa
58032;Civitavecchia;0;1;1;Belgio;Unione Europea;Europa
58032;Civitavecchia;0;1;1;Bosnia-Erzegovina;Europa Centro-Orientale;Europa
58032;Civitavecchia;1;0;1;Centrafricana, Repubblica;Africa Centro-Meridionale;Africa
58032;Civitavecchia;1;0;1;Congo, Repubblica democratica del (ex Zaire);Africa Centro-Meridionale;Africa
58032;Civitavecchia;0;1;1;Estonia;Unione Europea;Europa
58032;Civitavecchia;0;1;1;Finlandia;Unione Europea;Europa
58032;Civitavecchia;1;0;1;Haiti;America Centro-Meridionale;America
58032;Civitavecchia;0;1;1;Irlanda;Unione Europea;Europa
58032;Civitavecchia;0;1;1;Israele;Asia Occidentale;Asia
58032;Civitavecchia;0;1;1;Kenya;Africa Orientale;Africa
58032;Civitavecchia;0;1;1;Lettonia;Unione Europea;Europa
58032;Civitavecchia;1;0;1;Macedonia del Nord;Europa Centro-Orientale;Europa
58032;Civitavecchia;1;0;1;Malta;Unione Europea;Europa
58032;Civitavecchia;0;1;1;Mauritania;Africa Occidentale;Africa
58032;Civitavecchia;0;1;1;Nepal;Asia Centro-Meridionale;Asia
58032;Civitavecchia;1;0;1;Norvegia;Altri paesi europei;Europa
58032;Civitavecchia;1;0;1;Nuova Zelanda;Oceania;Oceania
58032;Civitavecchia;0;1;1;Paesi Bassi;Unione Europea;Europa
58032;Civitavecchia;0;1;1;Portogallo;Unione Europea;Europa
58032;Civitavecchia;1;0;1;Ruanda;Africa Orientale;Africa
58032;Civitavecchia;0;1;1;Slovacchia;Unione Europea;Europa
58032;Civitavecchia;0;1;1;Svezia;Unione Europea;Europa
58032;Civitavecchia;0;1;1;Svizzera;Altri paesi europei;Europa
58032;Civitavecchia;0;1;1;Tanzania;Africa Orientale;Africa
58032;Civitavecchia;1;0;1;Uganda;Africa Orientale;Africa
58032;Civitavecchia;0;1;1;Vietnam;Asia Orientale;Asia
58033;Civitella San Paolo;134;155;289;Romania;Unione Europea;Europa
58033;Civitella San Paolo;40;39;79;Albania;Europa Centro-Orientale;Europa
58033;Civitella San Paolo;12;4;16;Marocco;Africa Settentrionale;Africa
58033;Civitella San Paolo;2;5;7;Moldova;Europa Centro-Orientale;Europa
58033;Civitella San Paolo;4;3;7;Polonia;Unione Europea;Europa
58033;Civitella San Paolo;5;1;6;Egitto;Africa Settentrionale;Africa
58033;Civitella San Paolo;4;2;6;India;Asia Centro-Meridionale;Asia
58033;Civitella San Paolo;4;1;5;Tunisia;Africa Settentrionale;Africa
58033;Civitella San Paolo;2;2;4;Pakistan;Asia Centro-Meridionale;Asia
58033;Civitella San Paolo;1;3;4;Perù;America Centro-Meridionale;America
58033;Civitella San Paolo;2;2;4;Siria;Asia Occidentale;Asia
58033;Civitella San Paolo;0;4;4;Ucraina;Europa Centro-Orientale;Europa
58033;Civitella San Paolo;3;0;3;Bangladesh;Asia Centro-Meridionale;Asia
58033;Civitella San Paolo;3;0;3;Costa d'Avorio;Africa Occidentale;Africa
58033;Civitella San Paolo;0;2;2;Bulgaria;Unione Europea;Europa
58033;Civitella San Paolo;0;2;2;Dominicana, Repubblica;America Centro-Meridionale;America
58033;Civitella San Paolo;0;2;2;Germania;Unione Europea;Europa
58033;Civitella San Paolo;2;0;2;Mali;Africa Occidentale;Africa
58033;Civitella San Paolo;2;0;2;Paesi Bassi;Unione Europea;Europa
58033;Civitella San Paolo;0;2;2;Regno Unito;Altri paesi europei;Europa
58033;Civitella San Paolo;0;1;1;Algeria;Africa Settentrionale;Africa
58033;Civitella San Paolo;1;0;1;Argentina;America Centro-Meridionale;America
58033;Civitella San Paolo;0;1;1;Belgio;Unione Europea;Europa
58033;Civitella San Paolo;0;1;1;Brasile;America Centro-Meridionale;America
58033;Civitella San Paolo;1;0;1;Colombia;America Centro-Meridionale;America
58033;Civitella San Paolo;0;1;1;Ecuador;America Centro-Meridionale;America
58033;Civitella San Paolo;1;0;1;Filippine;Asia Orientale;Asia
58033;Civitella San Paolo;0;1;1;Mauritius;Africa Orientale;Africa
58033;Civitella San Paolo;0;1;1;Russa, Federazione;Europa Centro-Orientale;Europa
58033;Civitella San Paolo;0;1;1;Spagna;Unione Europea;Europa
58033;Civitella San Paolo;0;1;1;Stati Uniti d'America;America Settentrionale;America
58033;Civitella San Paolo;0;1;1;Ungheria;Unione Europea;Europa
58034;Colleferro;241;298;539;Romania;Unione Europea;Europa
58034;Colleferro;172;231;403;Bulgaria;Unione Europea;Europa
58034;Colleferro;112;96;208;Nigeria;Africa Occidentale;Africa
58034;Colleferro;59;66;125;Albania;Europa Centro-Orientale;Europa
58034;Colleferro;40;47;87;Marocco;Africa Settentrionale;Africa
58034;Colleferro;34;31;65;Cinese, Repubblica Popolare;Asia Orientale;Asia
58034;Colleferro;45;14;59;Egitto;Africa Settentrionale;Africa
58034;Colleferro;11;31;42;Ucraina;Europa Centro-Orientale;Europa
58034;Colleferro;13;20;33;Moldova;Europa Centro-Orientale;Europa
58034;Colleferro;17;15;32;Burkina Faso (ex Alto Volta);Africa Occidentale;Africa
58034;Colleferro;19;13;32;India;Asia Centro-Meridionale;Asia
58034;Colleferro;17;15;32;Perù;America Centro-Meridionale;America
58034;Colleferro;12;16;28;Polonia;Unione Europea;Europa
58034;Colleferro;17;10;27;Tunisia;Africa Settentrionale;Africa
58034;Colleferro;15;5;20;Congo, Repubblica democratica del (ex Zaire);Africa Centro-Meridionale;Africa
58034;Colleferro;3;15;18;Brasile;America Centro-Meridionale;America
58034;Colleferro;10;8;18;Senegal;Africa Occidentale;Africa
58034;Colleferro;7;9;16;Filippine;Asia Orientale;Asia
58034;Colleferro;3;9;12;Cuba;America Centro-Meridionale;America
58034;Colleferro;5;6;11;Turchia;Europa Centro-Orientale;Europa
58034;Colleferro;4;5;9;Macedonia del Nord;Europa Centro-Orientale;Europa
58034;Colleferro;7;1;8;Bangladesh;Asia Centro-Meridionale;Asia
58034;Colleferro;6;2;8;Benin (ex Dahomey);Africa Occidentale;Africa
58034;Colleferro;5;2;7;Algeria;Africa Settentrionale;Africa
58034;Colleferro;4;3;7;Apolide;;
58034;Colleferro;3;3;6;Ecuador;America Centro-Meridionale;America
58034;Colleferro;3;3;6;Siria;Asia Occidentale;Asia
58034;Colleferro;3;2;5;Germania;Unione Europea;Europa
58034;Colleferro;1;4;5;Russa, Federazione;Europa Centro-Orientale;Europa
58034;Colleferro;2;3;5;Somalia;Africa Orientale;Africa
58034;Colleferro;2;3;5;Spagna;Unione Europea;Europa
58034;Colleferro;2;2;4;Camerun;Africa Centro-Meridionale;Africa
58034;Colleferro;2;2;4;Ghana;Africa Occidentale;Africa
58034;Colleferro;2;2;4;Regno Unito;Altri paesi europei;Europa
58034;Colleferro;1;3;4;Togo;Africa Occidentale;Africa
58034;Colleferro;0;4;4;Venezuela;America Centro-Meridionale;America
58034;Colleferro;2;1;3;Capo Verde;Africa Occidentale;Africa
58034;Colleferro;2;1;3;Colombia;America Centro-Meridionale;America
58034;Colleferro;1;2;3;Dominicana, Repubblica;America Centro-Meridionale;America
58034;Colleferro;1;2;3;Francia;Unione Europea;Europa
58034;Colleferro;3;0;3;Pakistan;Asia Centro-Meridionale;Asia
58034;Colleferro;2;1;3;Slovacchia;Unione Europea;Europa
58034;Colleferro;2;1;3;Sri Lanka (ex Ceylon);Asia Centro-Meridionale;Asia
58034;Colleferro;1;2;3;Stati Uniti d'America;America Settentrionale;America
58034;Colleferro;2;0;2;Angola;Africa Centro-Meridionale;Africa
58034;Colleferro;0;2;2;Argentina;America Centro-Meridionale;America
58034;Colleferro;1;1;2;Costa d'Avorio;Africa Occidentale;Africa
58034;Colleferro;0;2;2;El Salvador;America Centro-Meridionale;America
58034;Colleferro;0;2;2;Etiopia;Africa Orientale;Africa
58034;Colleferro;1;1;2;Grecia;Unione Europea;Europa
58034;Colleferro;1;1;2;Kenya;Africa Orientale;Africa
58034;Colleferro;0;2;2;Lituania;Unione Europea;Europa
58034;Colleferro;1;1;2;Serbia, Repubblica di;Europa Centro-Orientale;Europa
58034;Colleferro;2;0;2;Sierra Leone;Africa Occidentale;Africa
58034;Colleferro;0;2;2;Zambia;Africa Orientale;Africa
58034;Colleferro;1;0;1;Australia;Oceania;Oceania
58034;Colleferro;1;0;1;Canada;America Settentrionale;America
58034;Colleferro;1;0;1;Croazia;Unione Europea;Europa
58034;Colleferro;0;1;1;Finlandia;Unione Europea;Europa
58034;Colleferro;1;0;1;Gabon;Africa Centro-Meridionale;Africa
58034;Colleferro;1;0;1;Gambia;Africa Occidentale;Africa
58034;Colleferro;0;1;1;Giappone;Asia Orientale;Asia
58034;Colleferro;0;1;1;Iran, Repubblica Islamica del;Asia Occidentale;Asia
58034;Colleferro;1;0;1;Mali;Africa Occidentale;Africa
58034;Colleferro;0;1;1;Mauritania;Africa Occidentale;Africa
58034;Colleferro;0;1;1;Messico;America Centro-Meridionale;America
58034;Colleferro;1;0;1;Portogallo;Unione Europea;Europa
58034;Colleferro;0;1;1;Taiwan (ex Formosa);Asia Orientale;Asia
58035;Colonna;175;179;354;Romania;Unione Europea;Europa
58035;Colonna;7;5;12;Nigeria;Africa Occidentale;Africa
58035;Colonna;5;6;11;Marocco;Africa Settentrionale;Africa
58035;Colonna;5;5;10;Moldova;Europa Centro-Orientale;Europa
58035;Colonna;3;5;8;Ucraina;Europa Centro-Orientale;Europa
58035;Colonna;3;4;7;Albania;Europa Centro-Orientale;Europa
58035;Colonna;4;1;5;Bangladesh;Asia Centro-Meridionale;Asia
58035;Colonna;3;2;5;Cinese, Repubblica Popolare;Asia Orientale;Asia
58035;Colonna;1;4;5;Filippine;Asia Orientale;Asia
58035;Colonna;2;2;4;Congo (Repubblica del);Africa Centro-Meridionale;Africa
58035;Colonna;1;3;4;Francia;Unione Europea;Europa
58035;Colonna;1;3;4;Polonia;Unione Europea;Europa
58035;Colonna;1;2;3;Cuba;America Centro-Meridionale;America
58035;Colonna;3;0;3;Egitto;Africa Settentrionale;Africa
58035;Colonna;1;1;2;Brasile;America Centro-Meridionale;America
58035;Colonna;1;1;2;Camerun;Africa Centro-Meridionale;Africa
58035;Colonna;2;0;2;Kosovo;Europa Centro-Orientale;Europa
58035;Colonna;1;1;2;Perù;America Centro-Meridionale;America
58035;Colonna;1;0;1;Austria;Unione Europea;Europa
58035;Colonna;0;1;1;Colombia;America Centro-Meridionale;America
58035;Colonna;0;1;1;Finlandia;Unione Europea;Europa
58035;Colonna;1;0;1;Germania;Unione Europea;Europa
58035;Colonna;1;0;1;Ghana;Africa Occidentale;Africa
58035;Colonna;1;0;1;India;Asia Centro-Meridionale;Asia
58035;Colonna;1;0;1;Iraq;Asia Occidentale;Asia
58035;Colonna;1;0;1;Pakistan;Asia Centro-Meridionale;Asia
58035;Colonna;1;0;1;Regno Unito;Altri paesi europei;Europa
58035;Colonna;1;0;1;Russa, Federazione;Europa Centro-Orientale;Europa
58035;Colonna;1;0;1;Senegal;Africa Occidentale;Africa
58035;Colonna;0;1;1;Seychelles;Africa Orientale;Africa
58035;Colonna;0;1;1;Spagna;Unione Europea;Europa
58035;Colonna;0;1;1;Sudan;Africa Settentrionale;Africa
58035;Colonna;0;1;1;Venezuela;America Centro-Meridionale;America
58036;Fiano Romano;575;549;1124;Romania;Unione Europea;Europa
58036;Fiano Romano;186;152;338;Albania;Europa Centro-Orientale;Europa
58036;Fiano Romano;80;35;115;Bangladesh;Asia Centro-Meridionale;Asia
58036;Fiano Romano;35;32;67;Marocco;Africa Settentrionale;Africa
58036;Fiano Romano;50;12;62;Pakistan;Asia Centro-Meridionale;Asia
58036;Fiano Romano;35;23;58;India;Asia Centro-Meridionale;Asia
58036;Fiano Romano;20;37;57;Polonia;Unione Europea;Europa
58036;Fiano Romano;43;9;52;Nigeria;Africa Occidentale;Africa
58036;Fiano Romano;20;23;43;Moldova;Europa Centro-Orientale;Europa
58036;Fiano Romano;6;29;35;Ucraina;Europa Centro-Orientale;Europa
58036;Fiano Romano;14;17;31;Perù;America Centro-Meridionale;America
58036;Fiano Romano;27;2;29;Egitto;Africa Settentrionale;Africa
58036;Fiano Romano;7;15;22;Cuba;America Centro-Meridionale;America
58036;Fiano Romano;7;15;22;Filippine;Asia Orientale;Asia
58036;Fiano Romano;15;7;22;Guinea;Africa Occidentale;Africa
58036;Fiano Romano;16;6;22;Mali;Africa Occidentale;Africa
58036;Fiano Romano;5;16;21;Brasile;America Centro-Meridionale;America
58036;Fiano Romano;12;8;20;Cinese, Repubblica Popolare;Asia Orientale;Asia
58036;Fiano Romano;10;10;20;Macedonia del Nord;Europa Centro-Orientale;Europa
58036;Fiano Romano;11;7;18;Algeria;Africa Settentrionale;Africa
58036;Fiano Romano;18;0;18;Somalia;Africa Orientale;Africa
58036;Fiano Romano;12;5;17;Senegal;Africa Occidentale;Africa
58036;Fiano Romano;8;8;16;Colombia;America Centro-Meridionale;America
58036;Fiano Romano;2;14;16;Russa, Federazione;Europa Centro-Orientale;Europa
58036;Fiano Romano;6;9;15;Tunisia;Africa Settentrionale;Africa
58036;Fiano Romano;7;6;13;Argentina;America Centro-Meridionale;America
58036;Fiano Romano;10;3;13;Togo;Africa Occidentale;Africa
58036;Fiano Romano;4;8;12;Etiopia;Africa Orientale;Africa
58036;Fiano Romano;6;5;11;Camerun;Africa Centro-Meridionale;Africa
58036;Fiano Romano;4;7;11;Ecuador;America Centro-Meridionale;America
58036;Fiano Romano;7;3;10;Eritrea;Africa Orientale;Africa
58036;Fiano Romano;3;6;9;Germania;Unione Europea;Europa
58036;Fiano Romano;7;1;8;Afghanistan;Asia Centro-Meridionale;Asia
58036;Fiano Romano;4;4;8;Bolivia;America Centro-Meridionale;America
58036;Fiano Romano;2;6;8;Spagna;Unione Europea;Europa
58036;Fiano Romano;3;4;7;Capo Verde;Africa Occidentale;Africa
58036;Fiano Romano;5;2;7;Costa d'Avorio;Africa Occidentale;Africa
58036;Fiano Romano;1;6;7;Portogallo;Unione Europea;Europa
58036;Fiano Romano;5;2;7;Sri Lanka (ex Ceylon);Asia Centro-Meridionale;Asia
58036;Fiano Romano;1;5;6;Bulgaria;Unione Europea;Europa
58036;Fiano Romano;2;4;6;Francia;Unione Europea;Europa
58036;Fiano Romano;3;3;6;Niger;Africa Occidentale;Africa
58036;Fiano Romano;1;5;6;Regno Unito;Altri paesi europei;Europa
58036;Fiano Romano;3;3;6;Serbia, Repubblica di;Europa Centro-Orientale;Europa
58036;Fiano Romano;5;0;5;Gambia;Africa Occidentale;Africa
58036;Fiano Romano;2;3;5;Siria;Asia Occidentale;Asia
58036;Fiano Romano;5;0;5;Sudan;Africa Settentrionale;Africa
58036;Fiano Romano;2;2;4;Bielorussia;Europa Centro-Orientale;Europa
58036;Fiano Romano;4;0;4;Burkina Faso (ex Alto Volta);Africa Occidentale;Africa
58036;Fiano Romano;2;2;4;Dominicana, Repubblica;America Centro-Meridionale;America
58036;Fiano Romano;2;2;4;Iran, Repubblica Islamica del;Asia Occidentale;Asia
58036;Fiano Romano;3;0;3;Ghana;Africa Occidentale;Africa
58036;Fiano Romano;3;0;3;Guinea Bissau;Africa Occidentale;Africa
58036;Fiano Romano;3;0;3;Iraq;Asia Occidentale;Asia
58036;Fiano Romano;0;3;3;Kenya;Africa Orientale;Africa
58036;Fiano Romano;3;0;3;Sierra Leone;Africa Occidentale;Africa
58036;Fiano Romano;1;2;3;Svizzera;Altri paesi europei;Europa
58036;Fiano Romano;1;2;3;Ungheria;Unione Europea;Europa
58036;Fiano Romano;0;2;2;Ceca, Repubblica;Unione Europea;Europa
58036;Fiano Romano;1;1;2;Danimarca;Unione Europea;Europa
58036;Fiano Romano;0;2;2;El Salvador;America Centro-Meridionale;America
58036;Fiano Romano;2;0;2;Irlanda;Unione Europea;Europa
58036;Fiano Romano;2;0;2;Lituania;Unione Europea;Europa
58036;Fiano Romano;1;1;2;Ruanda;Africa Orientale;Africa
58036;Fiano Romano;0;2;2;Slovacchia;Unione Europea;Europa
58036;Fiano Romano;0;2;2;Stati Uniti d'America;America Settentrionale;America
58036;Fiano Romano;0;2;2;Venezuela;America Centro-Meridionale;America
58036;Fiano Romano;0;1;1;Giappone;Asia Orientale;Asia
58036;Fiano Romano;1;0;1;Grecia;Unione Europea;Europa
58036;Fiano Romano;0;1;1;Guatemala;America Centro-Meridionale;America
58036;Fiano Romano;1;0;1;Honduras;America Centro-Meridionale;America
58036;Fiano Romano;0;1;1;Kazakhstan;Asia Centro-Meridionale;Asia
58036;Fiano Romano;0;1;1;Mauritius;Africa Orientale;Africa
58036;Fiano Romano;0;1;1;Nicaragua;America Centro-Meridionale;America
58036;Fiano Romano;0;1;1;Paesi Bassi;Unione Europea;Europa
58036;Fiano Romano;0;1;1;Svezia;Unione Europea;Europa
58036;Fiano Romano;1;0;1;Turchia;Europa Centro-Orientale;Europa
58036;Fiano Romano;0;1;1;Uganda;Africa Orientale;Africa
58036;Fiano Romano;0;1;1;Vietnam;Asia Orientale;Asia
58037;Filacciano;14;6;20;Romania;Unione Europea;Europa
58037;Filacciano;1;3;4;Albania;Europa Centro-Orientale;Europa
58037;Filacciano;0;3;3;Moldova;Europa Centro-Orientale;Europa
58037;Filacciano;1;2;3;Ucraina;Europa Centro-Orientale;Europa
58037;Filacciano;0;2;2;Germania;Unione Europea;Europa
58037;Filacciano;1;1;2;Polonia;Unione Europea;Europa
58037;Filacciano;1;0;1;Argentina;America Centro-Meridionale;America
58037;Filacciano;1;0;1;Bangladesh;Asia Centro-Meridionale;Asia
58037;Filacciano;1;0;1;Cuba;America Centro-Meridionale;America
58037;Filacciano;1;0;1;Dominicana, Repubblica;America Centro-Meridionale;America
58037;Filacciano;0;1;1;Filippine;Asia Orientale;Asia
58037;Filacciano;0;1;1;Francia;Unione Europea;Europa
58037;Filacciano;0;1;1;Kazakhstan;Asia Centro-Meridionale;Asia
58037;Filacciano;1;0;1;Marocco;Africa Settentrionale;Africa
58037;Filacciano;1;0;1;Perù;America Centro-Meridionale;America
58120;Fiumicino;1994;2111;4105;Romania;Unione Europea;Europa
58120;Fiumicino;331;328;659;Cinese, Repubblica Popolare;Asia Orientale;Asia
58120;Fiumicino;499;151;650;Bangladesh;Asia Centro-Meridionale;Asia
58120;Fiumicino;442;194;636;India;Asia Centro-Meridionale;Asia
58120;Fiumicino;401;122;523;Egitto;Africa Settentrionale;Africa
58120;Fiumicino;97;219;316;Polonia;Unione Europea;Europa
58120;Fiumicino;81;222;303;Ucraina;Europa Centro-Orientale;Europa
58120;Fiumicino;103;136;239;Bulgaria;Unione Europea;Europa
58120;Fiumicino;124;81;205;Marocco;Africa Settentrionale;Africa
58120;Fiumicino;100;57;157;Tunisia;Africa Settentrionale;Africa
58120;Fiumicino;66;62;128;Filippine;Asia Orientale;Asia
58120;Fiumicino;43;77;120;Moldova;Europa Centro-Orientale;Europa
58120;Fiumicino;27;76;103;Brasile;America Centro-Meridionale;America
58120;Fiumicino;46;50;96;Albania;Europa Centro-Orientale;Europa
58120;Fiumicino;41;39;80;Spagna;Unione Europea;Europa
58120;Fiumicino;41;32;73;Sri Lanka (ex Ceylon);Asia Centro-Meridionale;Asia
58120;Fiumicino;16;49;65;Russa, Federazione;Europa Centro-Orientale;Europa
58120;Fiumicino;23;40;63;Cuba;America Centro-Meridionale;America
58120;Fiumicino;15;39;54;Perù;America Centro-Meridionale;America
58120;Fiumicino;17;34;51;Francia;Unione Europea;Europa
58120;Fiumicino;8;28;36;Germania;Unione Europea;Europa
58120;Fiumicino;33;2;35;Pakistan;Asia Centro-Meridionale;Asia
58120;Fiumicino;14;20;34;Nigeria;Africa Occidentale;Africa
58120;Fiumicino;13;21;34;Regno Unito;Altri paesi europei;Europa
58120;Fiumicino;16;15;31;Ecuador;America Centro-Meridionale;America
58120;Fiumicino;15;16;31;Venezuela;America Centro-Meridionale;America
58120;Fiumicino;12;18;30;Colombia;America Centro-Meridionale;America
58120;Fiumicino;14;15;29;Macedonia del Nord;Europa Centro-Orientale;Europa
58120;Fiumicino;10;15;25;Iran, Repubblica Islamica del;Asia Occidentale;Asia
58120;Fiumicino;6;17;23;Bielorussia;Europa Centro-Orientale;Europa
58120;Fiumicino;16;6;22;Algeria;Africa Settentrionale;Africa
58120;Fiumicino;12;10;22;Portogallo;Unione Europea;Europa
58120;Fiumicino;13;8;21;Senegal;Africa Occidentale;Africa
58120;Fiumicino;10;10;20;Argentina;America Centro-Meridionale;America
58120;Fiumicino;9;11;20;Dominicana, Repubblica;America Centro-Meridionale;America
58120;Fiumicino;8;11;19;Giappone;Asia Orientale;Asia
58120;Fiumicino;13;6;19;Libia;Africa Settentrionale;Africa
58120;Fiumicino;8;10;18;Messico;America Centro-Meridionale;America
58120;Fiumicino;7;11;18;Stati Uniti d'America;America Settentrionale;America
58120;Fiumicino;1;15;16;Thailandia;Asia Orientale;Asia
58120;Fiumicino;2;11;13;Capo Verde;Africa Occidentale;Africa
58120;Fiumicino;8;4;12;Camerun;Africa Centro-Meridionale;Africa
58120;Fiumicino;1;11;12;Croazia;Unione Europea;Europa
58120;Fiumicino;4;8;12;Lituania;Unione Europea;Europa
58120;Fiumicino;4;8;12;Svezia;Unione Europea;Europa
58120;Fiumicino;5;7;12;Ungheria;Unione Europea;Europa
58120;Fiumicino;3;8;11;Belgio;Unione Europea;Europa
58120;Fiumicino;6;5;11;Costa d'Avorio;Africa Occidentale;Africa
58120;Fiumicino;0;11;11;Indonesia;Asia Orientale;Asia
58120;Fiumicino;7;3;10;Ghana;Africa Occidentale;Africa
58120;Fiumicino;5;5;10;Siria;Asia Occidentale;Asia
58120;Fiumicino;9;0;9;Gambia;Africa Occidentale;Africa
58120;Fiumicino;1;8;9;Georgia;Asia Occidentale;Asia
58120;Fiumicino;4;5;9;Grecia;Unione Europea;Europa
58120;Fiumicino;4;5;9;Serbia, Repubblica di;Europa Centro-Orientale;Europa
58120;Fiumicino;5;3;8;Cile;America Centro-Meridionale;America
58120;Fiumicino;1;7;8;Slovacchia;Unione Europea;Europa
58120;Fiumicino;2;6;8;Uzbekistan;Asia Centro-Meridionale;Asia
58120;Fiumicino;2;5;7;Austria;Unione Europea;Europa
58120;Fiumicino;2;5;7;Azerbaigian;Asia Occidentale;Asia
58120;Fiumicino;0;7;7;Canada;America Settentrionale;America
58120;Fiumicino;0;7;7;Corea, Repubblica (Corea del Sud);Asia Orientale;Asia
58120;Fiumicino;1;6;7;El Salvador;America Centro-Meridionale;America
58120;Fiumicino;1;6;7;Eritrea;Africa Orientale;Africa
58120;Fiumicino;1;6;7;Etiopia;Africa Orientale;Africa
58120;Fiumicino;3;4;7;Honduras;America Centro-Meridionale;America
58120;Fiumicino;6;1;7;Mali;Africa Occidentale;Africa
58120;Fiumicino;2;5;7;Paesi Bassi;Unione Europea;Europa
58120;Fiumicino;4;3;7;Tanzania;Africa Orientale;Africa
58120;Fiumicino;6;1;7;Turchia;Europa Centro-Orientale;Europa
58120;Fiumicino;2;4;6;Ceca, Repubblica;Unione Europea;Europa
58120;Fiumicino;4;2;6;Estonia;Unione Europea;Europa
58120;Fiumicino;1;5;6;Finlandia;Unione Europea;Europa
58120;Fiumicino;3;3;6;Irlanda;Unione Europea;Europa
58120;Fiumicino;3;3;6;Nicaragua;America Centro-Meridionale;America
58120;Fiumicino;1;4;5;Australia;Oceania;Oceania
58120;Fiumicino;5;0;5;Iraq;Asia Occidentale;Asia
58120;Fiumicino;2;3;5;Israele;Asia Occidentale;Asia
58120;Fiumicino;0;5;5;Kazakhstan;Asia Centro-Meridionale;Asia
58120;Fiumicino;4;1;5;Sudan;Africa Settentrionale;Africa
58120;Fiumicino;2;3;5;Svizzera;Altri paesi europei;Europa
58120;Fiumicino;4;0;4;Afghanistan;Asia Centro-Meridionale;Asia
58120;Fiumicino;4;0;4;Guinea;Africa Occidentale;Africa
58120;Fiumicino;1;3;4;Lettonia;Unione Europea;Europa
58120;Fiumicino;3;1;4;Montenegro;Europa Centro-Orientale;Europa
58120;Fiumicino;0;4;4;Paraguay;America Centro-Meridionale;America
58120;Fiumicino;2;2;4;Somalia;Africa Orientale;Africa
58120;Fiumicino;3;1;4;Togo;Africa Occidentale;Africa
58120;Fiumicino;2;1;3;Bolivia;America Centro-Meridionale;America
58120;Fiumicino;3;0;3;Burkina Faso (ex Alto Volta);Africa Occidentale;Africa
58120;Fiumicino;2;1;3;Ciad;Africa Centro-Meridionale;Africa
58120;Fiumicino;2;1;3;Kenya;Africa Orientale;Africa
58120;Fiumicino;3;0;3;Kosovo;Europa Centro-Orientale;Europa
58120;Fiumicino;1;1;2;Angola;Africa Centro-Meridionale;Africa
58120;Fiumicino;0;2;2;Benin (ex Dahomey);Africa Occidentale;Africa
58120;Fiumicino;1;1;2;Bosnia-Erzegovina;Europa Centro-Orientale;Europa
58120;Fiumicino;0;2;2;Congo (Repubblica del);Africa Centro-Meridionale;Africa
58120;Fiumicino;1;1;2;Congo, Repubblica democratica del (ex Zaire);Africa Centro-Meridionale;Africa
58120;Fiumicino;1;1;2;Danimarca;Unione Europea;Europa
58120;Fiumicino;0;2;2;Libano;Asia Occidentale;Asia
58120;Fiumicino;0;2;2;Madagascar;Africa Orientale;Africa
58120;Fiumicino;1;1;2;Mozambico;Africa Orientale;Africa
58120;Fiumicino;2;0;2;Nepal;Asia Centro-Meridionale;Asia
58120;Fiumicino;0;2;2;Norvegia;Altri paesi europei;Europa
58120;Fiumicino;1;0;1;Arabia Saudita;Asia Occidentale;Asia
58120;Fiumicino;1;0;1;Armenia;Asia Occidentale;Asia
58120;Fiumicino;0;1;1;Cipro;Unione Europea;Europa
58120;Fiumicino;0;1;1;Giamaica;America Centro-Meridionale;America
58120;Fiumicino;0;1;1;Guatemala;America Centro-Meridionale;America
58120;Fiumicino;1;0;1;Kirghizistan;Asia Centro-Meridionale;Asia
58120;Fiumicino;0;1;1;Lussemburgo;Unione Europea;Europa
58120;Fiumicino;1;0;1;Malta;Unione Europea;Europa
58120;Fiumicino;0;1;1;Mauritius;Africa Orientale;Africa
58120;Fiumicino;1;0;1;San Marino;Altri paesi europei;Europa
58120;Fiumicino;0;1;1;Seychelles;Africa Orientale;Africa
58120;Fiumicino;1;0;1;Sierra Leone;Africa Occidentale;Africa
58120;Fiumicino;0;1;1;Singapore;Asia Orientale;Asia
58120;Fiumicino;0;1;1;Slovenia;Unione Europea;Europa
58120;Fiumicino;0;1;1;Sud Africa;Africa Centro-Meridionale;Africa
58120;Fiumicino;0;1;1;Taiwan (ex Formosa);Asia Orientale;Asia
58120;Fiumicino;0;1;1;Territori dell'Autonomia Palestinese;Asia Occidentale;Asia
58120;Fiumicino;0;1;1;Timor Orientale;Asia Orientale;Asia
58120;Fiumicino;0;1;1;Uruguay;America Centro-Meridionale;America
58120;Fiumicino;0;1;1;Vietnam;Asia Orientale;Asia
58122;Fonte Nuova;1556;1594;3150;Romania;Unione Europea;Europa
58122;Fonte Nuova;286;290;576;Albania;Europa Centro-Orientale;Europa
58122;Fonte Nuova;129;51;180;Bangladesh;Asia Centro-Meridionale;Asia
58122;Fonte Nuova;79;75;154;Perù;America Centro-Meridionale;America
58122;Fonte Nuova;85;49;134;Macedonia del Nord;Europa Centro-Orientale;Europa
58122;Fonte Nuova;51;73;124;Moldova;Europa Centro-Orientale;Europa
58122;Fonte Nuova;29;92;121;Ucraina;Europa Centro-Orientale;Europa
58122;Fonte Nuova;66;52;118;Sri Lanka (ex Ceylon);Asia Centro-Meridionale;Asia
58122;Fonte Nuova;62;55;117;Kosovo;Europa Centro-Orientale;Europa
58122;Fonte Nuova;32;71;103;Polonia;Unione Europea;Europa
58122;Fonte Nuova;64;27;91;Egitto;Africa Settentrionale;Africa
58122;Fonte Nuova;27;37;64;Filippine;Asia Orientale;Asia
58122;Fonte Nuova;28;26;54;Cinese, Repubblica Popolare;Asia Orientale;Asia
58122;Fonte Nuova;42;2;44;Iraq;Asia Occidentale;Asia
58122;Fonte Nuova;23;16;39;Marocco;Africa Settentrionale;Africa
58122;Fonte Nuova;11;17;28;Ecuador;America Centro-Meridionale;America
58122;Fonte Nuova;21;7;28;India;Asia Centro-Meridionale;Asia
58122;Fonte Nuova;15;13;28;Tunisia;Africa Settentrionale;Africa
58122;Fonte Nuova;11;10;21;El Salvador;America Centro-Meridionale;America
58122;Fonte Nuova;9;12;21;Nigeria;Africa Occidentale;Africa
58122;Fonte Nuova;7;11;18;Brasile;America Centro-Meridionale;America
58122;Fonte Nuova;11;7;18;Congo (Repubblica del);Africa Centro-Meridionale;Africa
58122;Fonte Nuova;10;6;16;Somalia;Africa Orientale;Africa
58122;Fonte Nuova;13;2;15;Pakistan;Asia Centro-Meridionale;Asia
58122;Fonte Nuova;9;4;13;Bosnia-Erzegovina;Europa Centro-Orientale;Europa
58122;Fonte Nuova;4;9;13;Cuba;America Centro-Meridionale;America
58122;Fonte Nuova;5;8;13;Francia;Unione Europea;Europa
58122;Fonte Nuova;4;8;12;Colombia;America Centro-Meridionale;America
58122;Fonte Nuova;7;5;12;Congo, Repubblica democratica del (ex Zaire);Africa Centro-Meridionale;Africa
58122;Fonte Nuova;3;8;11;Bulgaria;Unione Europea;Europa
58122;Fonte Nuova;9;2;11;Senegal;Africa Occidentale;Africa
58122;Fonte Nuova;3;8;11;Spagna;Unione Europea;Europa
58122;Fonte Nuova;2;8;10;Russa, Federazione;Europa Centro-Orientale;Europa
58122;Fonte Nuova;4;4;8;Capo Verde;Africa Occidentale;Africa
58122;Fonte Nuova;5;3;8;Iran, Repubblica Islamica del;Asia Occidentale;Asia
58122;Fonte Nuova;1;7;8;Paraguay;America Centro-Meridionale;America
58122;Fonte Nuova;2;5;7;Eritrea;Africa Orientale;Africa
58122;Fonte Nuova;1;6;7;Germania;Unione Europea;Europa
58122;Fonte Nuova;6;0;6;Afghanistan;Asia Centro-Meridionale;Asia
58122;Fonte Nuova;2;4;6;Croazia;Unione Europea;Europa
58122;Fonte Nuova;1;4;5;Bielorussia;Europa Centro-Orientale;Europa
58122;Fonte Nuova;3;2;5;Bolivia;America Centro-Meridionale;America
58122;Fonte Nuova;1;4;5;Etiopia;Africa Orientale;Africa
58122;Fonte Nuova;2;3;5;Honduras;America Centro-Meridionale;America
58122;Fonte Nuova;2;3;5;Madagascar;Africa Orientale;Africa
58122;Fonte Nuova;2;3;5;Portogallo;Unione Europea;Europa
58122;Fonte Nuova;0;5;5;Thailandia;Asia Orientale;Asia
58122;Fonte Nuova;2;2;4;Argentina;America Centro-Meridionale;America
58122;Fonte Nuova;3;1;4;Cile;America Centro-Meridionale;America
58122;Fonte Nuova;0;4;4;Georgia;Asia Occidentale;Asia
58122;Fonte Nuova;1;3;4;Kenya;Africa Orientale;Africa
58122;Fonte Nuova;4;0;4;Mali;Africa Occidentale;Africa
58122;Fonte Nuova;2;2;4;Regno Unito;Altri paesi europei;Europa
58122;Fonte Nuova;3;1;4;Turchia;Europa Centro-Orientale;Europa
58122;Fonte Nuova;1;3;4;Venezuela;America Centro-Meridionale;America
58122;Fonte Nuova;2;1;3;Camerun;Africa Centro-Meridionale;Africa
58122;Fonte Nuova;0;3;3;Ceca, Repubblica;Unione Europea;Europa
58122;Fonte Nuova;0;3;3;Danimarca;Unione Europea;Europa
58122;Fonte Nuova;0;3;3;Dominicana, Repubblica;America Centro-Meridionale;America
58122;Fonte Nuova;2;1;3;Giappone;Asia Orientale;Asia
58122;Fonte Nuova;2;1;3;Libano;Asia Occidentale;Asia
58122;Fonte Nuova;1;2;3;Paesi Bassi;Unione Europea;Europa
58122;Fonte Nuova;1;1;2;Armenia;Asia Occidentale;Asia
58122;Fonte Nuova;1;1;2;Ghana;Africa Occidentale;Africa
58122;Fonte Nuova;2;0;2;Libia;Africa Settentrionale;Africa
58122;Fonte Nuova;2;0;2;Messico;America Centro-Meridionale;America
58122;Fonte Nuova;2;0;2;Serbia, Repubblica di;Europa Centro-Orientale;Europa
58122;Fonte Nuova;2;0;2;Siria;Asia Occidentale;Asia
58122;Fonte Nuova;2;0;2;Togo;Africa Occidentale;Africa
58122;Fonte Nuova;2;0;2;Uruguay;America Centro-Meridionale;America
58122;Fonte Nuova;1;0;1;Algeria;Africa Settentrionale;Africa
58122;Fonte Nuova;0;1;1;Angola;Africa Centro-Meridionale;Africa
58122;Fonte Nuova;1;0;1;Apolide;;
58122;Fonte Nuova;0;1;1;Belgio;Unione Europea;Europa
58122;Fonte Nuova;1;0;1;Burkina Faso (ex Alto Volta);Africa Occidentale;Africa
58122;Fonte Nuova;0;1;1;Canada;America Settentrionale;America
58122;Fonte Nuova;0;1;1;Corea, Repubblica (Corea del Sud);Asia Orientale;Asia
58122;Fonte Nuova;0;1;1;Costa d'Avorio;Africa Occidentale;Africa
58122;Fonte Nuova;0;1;1;Costa Rica;America Centro-Meridionale;America
58122;Fonte Nuova;0;1;1;Estonia;Unione Europea;Europa
58122;Fonte Nuova;0;1;1;Finlandia;Unione Europea;Europa
58122;Fonte Nuova;0;1;1;Grecia;Unione Europea;Europa
58122;Fonte Nuova;0;1;1;Guatemala;America Centro-Meridionale;America
58122;Fonte Nuova;1;0;1;Guinea;Africa Occidentale;Africa
58122;Fonte Nuova;0;1;1;Indonesia;Asia Orientale;Asia
58122;Fonte Nuova;0;1;1;Irlanda;Unione Europea;Europa
58122;Fonte Nuova;0;1;1;Lituania;Unione Europea;Europa
58122;Fonte Nuova;0;1;1;Slovacchia;Unione Europea;Europa
58122;Fonte Nuova;1;0;1;Slovenia;Unione Europea;Europa
58122;Fonte Nuova;1;0;1;Stati Uniti d'America;America Settentrionale;America
58122;Fonte Nuova;0;1;1;Svizzera;Altri paesi europei;Europa
58038;Formello;198;281;479;Romania;Unione Europea;Europa
58038;Formello;115;100;215;Albania;Europa Centro-Orientale;Europa
58038;Formello;42;34;76;Sri Lanka (ex Ceylon);Asia Centro-Meridionale;Asia
58038;Formello;26;30;56;Filippine;Asia Orientale;Asia
58038;Formello;11;33;44;Polonia;Unione Europea;Europa
58038;Formello;19;23;42;Moldova;Europa Centro-Orientale;Europa
58038;Formello;14;21;35;Ucraina;Europa Centro-Orientale;Europa
58038;Formello;14;14;28;Ecuador;America Centro-Meridionale;America
58038;Formello;23;5;28;Egitto;Africa Settentrionale;Africa
58038;Formello;8;15;23;Regno Unito;Altri paesi europei;Europa
58038;Formello;8;13;21;Cinese, Repubblica Popolare;Asia Orientale;Asia
58038;Formello;17;3;20;Macedonia del Nord;Europa Centro-Orientale;Europa
58038;Formello;6;13;19;Francia;Unione Europea;Europa
58038;Formello;6;13;19;Nigeria;Africa Occidentale;Africa
58038;Formello;12;6;18;India;Asia Centro-Meridionale;Asia
58038;Formello;5;12;17;Brasile;America Centro-Meridionale;America
58038;Formello;8;9;17;El Salvador;America Centro-Meridionale;America
58038;Formello;10;6;16;Marocco;Africa Settentrionale;Africa
58038;Formello;6;9;15;Perù;America Centro-Meridionale;America
58038;Formello;6;9;15;Spagna;Unione Europea;Europa
58038;Formello;5;9;14;Stati Uniti d'America;America Settentrionale;America
58038;Formello;11;2;13;Bangladesh;Asia Centro-Meridionale;Asia
58038;Formello;4;6;10;Germania;Unione Europea;Europa
58038;Formello;7;3;10;Tunisia;Africa Settentrionale;Africa
58038;Formello;4;5;9;Cuba;America Centro-Meridionale;America
58038;Formello;0;9;9;Russa, Federazione;Europa Centro-Orientale;Europa
58038;Formello;5;2;7;Dominicana, Repubblica;America Centro-Meridionale;America
58038;Formello;3;4;7;Iran, Repubblica Islamica del;Asia Occidentale;Asia
58038;Formello;4;2;6;Camerun;Africa Centro-Meridionale;Africa
58038;Formello;2;4;6;Paesi Bassi;Unione Europea;Europa
58038;Formello;3;2;5;Belgio;Unione Europea;Europa
58038;Formello;0;5;5;Capo Verde;Africa Occidentale;Africa
58038;Formello;2;3;5;Montenegro;Europa Centro-Orientale;Europa
58038;Formello;0;5;5;Svezia;Unione Europea;Europa
58038;Formello;1;3;4;Australia;Oceania;Oceania
58038;Formello;2;2;4;Bulgaria;Unione Europea;Europa
58038;Formello;2;2;4;Colombia;America Centro-Meridionale;America
58038;Formello;3;1;4;Croazia;Unione Europea;Europa
58038;Formello;3;1;4;Kosovo;Europa Centro-Orientale;Europa
58038;Formello;3;1;4;Serbia, Repubblica di;Europa Centro-Orientale;Europa
58038;Formello;2;2;4;Slovacchia;Unione Europea;Europa
58038;Formello;1;2;3;Austria;Unione Europea;Europa
58038;Formello;0;3;3;Georgia;Asia Occidentale;Asia
58038;Formello;2;1;3;Grecia;Unione Europea;Europa
58038;Formello;3;0;3;Guinea;Africa Occidentale;Africa
58038;Formello;0;3;3;Honduras;America Centro-Meridionale;America
58038;Formello;1;2;3;Madagascar;Africa Orientale;Africa
58038;Formello;1;2;3;Portogallo;Unione Europea;Europa
58038;Formello;1;1;2;Argentina;America Centro-Meridionale;America
58038;Formello;0;2;2;Bielorussia;Europa Centro-Orientale;Europa
58038;Formello;1;1;2;Canada;America Settentrionale;America
58038;Formello;1;1;2;Giordania;Asia Occidentale;Asia
58038;Formello;1;1;2;Nepal;Asia Centro-Meridionale;Asia
58038;Formello;0;2;2;Svizzera;Altri paesi europei;Europa
58038;Formello;0;2;2;Uganda;Africa Orientale;Africa
58038;Formello;0;2;2;Ungheria;Unione Europea;Europa
58038;Formello;0;2;2;Venezuela;America Centro-Meridionale;America
58038;Formello;1;0;1;Danimarca;Unione Europea;Europa
58038;Formello;1;0;1;Etiopia;Africa Orientale;Africa
58038;Formello;0;1;1;Finlandia;Unione Europea;Europa
58038;Formello;0;1;1;Giappone;Asia Orientale;Asia
58038;Formello;0;1;1;Irlanda;Unione Europea;Europa
58038;Formello;0;1;1;Kenya;Africa Orientale;Africa
58038;Formello;1;0;1;Lituania;Unione Europea;Europa
58038;Formello;0;1;1;Mauritius;Africa Orientale;Africa
58038;Formello;0;1;1;Messico;America Centro-Meridionale;America
58038;Formello;0;1;1;Panama;America Centro-Meridionale;America
58038;Formello;1;0;1;Senegal;Africa Occidentale;Africa
58038;Formello;0;1;1;Thailandia;Asia Orientale;Asia
58038;Formello;0;1;1;Uruguay;America Centro-Meridionale;America
58038;Formello;0;1;1;Uzbekistan;Asia Centro-Meridionale;Asia
58039;Frascati;231;305;536;Romania;Unione Europea;Europa
58039;Frascati;41;59;100;Moldova;Europa Centro-Orientale;Europa
58039;Frascati;21;71;92;Ucraina;Europa Centro-Orientale;Europa
58039;Frascati;20;53;73;India;Asia Centro-Meridionale;Asia
58039;Frascati;26;37;63;Filippine;Asia Orientale;Asia
58039;Frascati;28;24;52;Kosovo;Europa Centro-Orientale;Europa
58039;Frascati;25;23;48;Albania;Europa Centro-Orientale;Europa
58039;Frascati;26;19;45;Egitto;Africa Settentrionale;Africa
58039;Frascati;27;9;36;Bangladesh;Asia Centro-Meridionale;Asia
58039;Frascati;11;24;35;Francia;Unione Europea;Europa
58039;Frascati;10;25;35;Polonia;Unione Europea;Europa
58039;Frascati;16;19;35;Spagna;Unione Europea;Europa
58039;Frascati;7;20;27;Cinese, Repubblica Popolare;Asia Orientale;Asia
58039;Frascati;15;9;24;Marocco;Africa Settentrionale;Africa
58039;Frascati;7;14;21;Germania;Unione Europea;Europa
58039;Frascati;4;15;19;Brasile;America Centro-Meridionale;America
58039;Frascati;6;12;18;Stati Uniti d'America;America Settentrionale;America
58039;Frascati;9;8;17;Sri Lanka (ex Ceylon);Asia Centro-Meridionale;Asia
58039;Frascati;6;9;15;Regno Unito;Altri paesi europei;Europa
58039;Frascati;4;11;15;Russa, Federazione;Europa Centro-Orientale;Europa
58039;Frascati;3;10;13;Perù;America Centro-Meridionale;America
58039;Frascati;7;4;11;Portogallo;Unione Europea;Europa
58039;Frascati;2;7;9;Cuba;America Centro-Meridionale;America
58039;Frascati;9;0;9;Pakistan;Asia Centro-Meridionale;Asia
58039;Frascati;5;3;8;Nigeria;Africa Occidentale;Africa
58039;Frascati;2;5;7;Etiopia;Africa Orientale;Africa
58039;Frascati;7;0;7;Senegal;Africa Occidentale;Africa
58039;Frascati;4;3;7;Togo;Africa Occidentale;Africa
58039;Frascati;4;3;7;Ungheria;Unione Europea;Europa
58039;Frascati;1;5;6;Croazia;Unione Europea;Europa
58039;Frascati;0;6;6;Giappone;Asia Orientale;Asia
58039;Frascati;2;4;6;Grecia;Unione Europea;Europa
58039;Frascati;4;2;6;Irlanda;Unione Europea;Europa
58039;Frascati;3;3;6;Mauritius;Africa Orientale;Africa
58039;Frascati;3;3;6;Svizzera;Altri paesi europei;Europa
58039;Frascati;3;2;5;Belgio;Unione Europea;Europa
58039;Frascati;0;5;5;Bulgaria;Unione Europea;Europa
58039;Frascati;3;2;5;Colombia;America Centro-Meridionale;America
58039;Frascati;3;2;5;Ghana;Africa Occidentale;Africa
58039;Frascati;2;3;5;Iran, Repubblica Islamica del;Asia Occidentale;Asia
58039;Frascati;1;3;4;Bielorussia;Europa Centro-Orientale;Europa
58039;Frascati;2;2;4;Finlandia;Unione Europea;Europa
58039;Frascati;4;0;4;Gambia;Africa Occidentale;Africa
58039;Frascati;1;3;4;Georgia;Asia Occidentale;Asia
58039;Frascati;2;2;4;Messico;America Centro-Meridionale;America
58039;Frascati;3;1;4;Paesi Bassi;Unione Europea;Europa
58039;Frascati;1;3;4;Svezia;Unione Europea;Europa
58039;Frascati;3;0;3;Afghanistan;Asia Centro-Meridionale;Asia
58039;Frascati;1;2;3;Cile;America Centro-Meridionale;America
58039;Frascati;1;2;3;Congo (Repubblica del);Africa Centro-Meridionale;Africa
58039;Frascati;1;2;3;Corea, Repubblica (Corea del Sud);Asia Orientale;Asia
58039;Frascati;1;2;3;Dominicana, Repubblica;America Centro-Meridionale;America
58039;Frascati;0;3;3;Kenya;Africa Orientale;Africa
58039;Frascati;3;0;3;Mali;Africa Occidentale;Africa
58039;Frascati;2;1;3;Serbia, Repubblica di;Europa Centro-Orientale;Europa
58039;Frascati;0;3;3;Slovacchia;Unione Europea;Europa
58039;Frascati;3;0;3;Turchia;Europa Centro-Orientale;Europa
58039;Frascati;1;2;3;Venezuela;America Centro-Meridionale;America
58039;Frascati;2;0;2;Camerun;Africa Centro-Meridionale;Africa
58039;Frascati;1;1;2;Canada;America Settentrionale;America
58039;Frascati;0;2;2;Ceca, Repubblica;Unione Europea;Europa
58039;Frascati;0;2;2;Congo, Repubblica democratica del (ex Zaire);Africa Centro-Meridionale;Africa
58039;Frascati;1;1;2;Costa d'Avorio;Africa Occidentale;Africa
58039;Frascati;1;1;2;Ecuador;America Centro-Meridionale;America
58039;Frascati;2;0;2;Iraq;Asia Occidentale;Asia
58039;Frascati;2;0;2;Libia;Africa Settentrionale;Africa
58039;Frascati;2;0;2;Norvegia;Altri paesi europei;Europa
58039;Frascati;0;2;2;Thailandia;Asia Orientale;Asia
58039;Frascati;2;0;2;Tunisia;Africa Settentrionale;Africa
58039;Frascati;0;2;2;Vietnam;Asia Orientale;Asia
58039;Frascati;1;0;1;Algeria;Africa Settentrionale;Africa
58039;Frascati;0;1;1;Angola;Africa Centro-Meridionale;Africa
58039;Frascati;0;1;1;Austria;Unione Europea;Europa
58039;Frascati;1;0;1;Benin (ex Dahomey);Africa Occidentale;Africa
58039;Frascati;0;1;1;Capo Verde;Africa Occidentale;Africa
58039;Frascati;1;0;1;Ciad;Africa Centro-Meridionale;Africa
58039;Frascati;0;1;1;Danimarca;Unione Europea;Europa
58039;Frascati;0;1;1;Estonia;Unione Europea;Europa
58039;Frascati;0;1;1;Guatemala;America Centro-Meridionale;America
58039;Frascati;0;1;1;Indonesia;Asia Orientale;Asia
58039;Frascati;1;0;1;Libano;Asia Occidentale;Asia
58039;Frascati;1;0;1;Lituania;Unione Europea;Europa
58039;Frascati;1;0;1;Macedonia del Nord;Europa Centro-Orientale;Europa
58039;Frascati;1;0;1;Malawi;Africa Orientale;Africa
58039;Frascati;1;0;1;Nepal;Asia Centro-Meridionale;Asia
58039;Frascati;0;1;1;Paraguay;America Centro-Meridionale;America
58039;Frascati;1;0;1;Ruanda;Africa Orientale;Africa
58039;Frascati;1;0;1;Zambia;Africa Orientale;Africa
58040;Gallicano nel Lazio;297;257;554;Romania;Unione Europea;Europa
58040;Gallicano nel Lazio;6;12;18;Moldova;Europa Centro-Orientale;Europa
58040;Gallicano nel Lazio;10;7;17;Ecuador;America Centro-Meridionale;America
58040;Gallicano nel Lazio;11;6;17;Marocco;Africa Settentrionale;Africa
58040;Gallicano nel Lazio;6;8;14;Albania;Europa Centro-Orientale;Europa
58040;Gallicano nel Lazio;3;11;14;Ucraina;Europa Centro-Orientale;Europa
58040;Gallicano nel Lazio;4;8;12;Polonia;Unione Europea;Europa
58040;Gallicano nel Lazio;8;2;10;Egitto;Africa Settentrionale;Africa
58040;Gallicano nel Lazio;5;5;10;Tunisia;Africa Settentrionale;Africa
58040;Gallicano nel Lazio;6;3;9;Cinese, Repubblica Popolare;Asia Orientale;Asia
58040;Gallicano nel Lazio;4;4;8;Perù;America Centro-Meridionale;America
58040;Gallicano nel Lazio;4;2;6;Kosovo;Europa Centro-Orientale;Europa
58040;Gallicano nel Lazio;2;2;4;Siria;Asia Occidentale;Asia
58040;Gallicano nel Lazio;1;2;3;Argentina;America Centro-Meridionale;America
58040;Gallicano nel Lazio;3;0;3;Bangladesh;Asia Centro-Meridionale;Asia
58040;Gallicano nel Lazio;2;1;3;Filippine;Asia Orientale;Asia
58040;Gallicano nel Lazio;1;2;3;India;Asia Centro-Meridionale;Asia
58040;Gallicano nel Lazio;1;2;3;Pakistan;Asia Centro-Meridionale;Asia
58040;Gallicano nel Lazio;2;1;3;Senegal;Africa Occidentale;Africa
58040;Gallicano nel Lazio;2;0;2;Bosnia-Erzegovina;Europa Centro-Orientale;Europa
58040;Gallicano nel Lazio;1;1;2;Brasile;America Centro-Meridionale;America
58040;Gallicano nel Lazio;2;0;2;Colombia;America Centro-Meridionale;America
58040;Gallicano nel Lazio;0;2;2;Croazia;Unione Europea;Europa
58040;Gallicano nel Lazio;0;2;2;Cuba;America Centro-Meridionale;America
58040;Gallicano nel Lazio;1;1;2;Francia;Unione Europea;Europa
58040;Gallicano nel Lazio;1;1;2;Germania;Unione Europea;Europa
58040;Gallicano nel Lazio;1;1;2;Grecia;Unione Europea;Europa
58040;Gallicano nel Lazio;0;2;2;Lituania;Unione Europea;Europa
58040;Gallicano nel Lazio;1;1;2;Regno Unito;Altri paesi europei;Europa
58040;Gallicano nel Lazio;0;2;2;Russa, Federazione;Europa Centro-Orientale;Europa
58040;Gallicano nel Lazio;1;1;2;Stati Uniti d'America;America Settentrionale;America
58040;Gallicano nel Lazio;1;0;1;Afghanistan;Asia Centro-Meridionale;Asia
58040;Gallicano nel Lazio;1;0;1;Algeria;Africa Settentrionale;Africa
58040;Gallicano nel Lazio;0;1;1;Austria;Unione Europea;Europa
58040;Gallicano nel Lazio;1;0;1;Benin (ex Dahomey);Africa Occidentale;Africa
58040;Gallicano nel Lazio;0;1;1;Bulgaria;Unione Europea;Europa
58040;Gallicano nel Lazio;0;1;1;Ceca, Repubblica;Unione Europea;Europa
58040;Gallicano nel Lazio;0;1;1;Danimarca;Unione Europea;Europa
58040;Gallicano nel Lazio;1;0;1;Iran, Repubblica Islamica del;Asia Occidentale;Asia
58040;Gallicano nel Lazio;1;0;1;Iraq;Asia Occidentale;Asia
58040;Gallicano nel Lazio;0;1;1;Nigeria;Africa Occidentale;Africa
58040;Gallicano nel Lazio;0;1;1;Portogallo;Unione Europea;Europa
58040;Gallicano nel Lazio;0;1;1;Serbia, Repubblica di;Europa Centro-Orientale;Europa
58040;Gallicano nel Lazio;1;0;1;Spagna;Unione Europea;Europa
58040;Gallicano nel Lazio;0;1;1;Togo;Africa Occidentale;Africa
58040;Gallicano nel Lazio;0;1;1;Venezuela;America Centro-Meridionale;America
58040;Gallicano nel Lazio;0;1;1;Vietnam;Asia Orientale;Asia
58041;Gavignano;13;14;27;Bulgaria;Unione Europea;Europa
58041;Gavignano;13;12;25;Albania;Europa Centro-Orientale;Europa
58041;Gavignano;5;6;11;Romania;Unione Europea;Europa
58041;Gavignano;2;3;5;Ucraina;Europa Centro-Orientale;Europa
58041;Gavignano;2;1;3;India;Asia Centro-Meridionale;Asia
58041;Gavignano;1;1;2;Marocco;Africa Settentrionale;Africa
58041;Gavignano;0;1;1;Brasile;America Centro-Meridionale;America
58041;Gavignano;1;0;1;Polonia;Unione Europea;Europa
58041;Gavignano;1;0;1;Venezuela;America Centro-Meridionale;America
58042;Genazzano;109;125;234;Romania;Unione Europea;Europa
58042;Genazzano;23;15;38;Marocco;Africa Settentrionale;Africa
58042;Genazzano;12;9;21;Albania;Europa Centro-Orientale;Europa
58042;Genazzano;8;13;21;Ucraina;Europa Centro-Orientale;Europa
58042;Genazzano;9;6;15;Nigeria;Africa Occidentale;Africa
58042;Genazzano;9;5;14;Cinese, Repubblica Popolare;Asia Orientale;Asia
58042;Genazzano;3;8;11;Polonia;Unione Europea;Europa
58042;Genazzano;3;5;8;Moldova;Europa Centro-Orientale;Europa
58042;Genazzano;4;2;6;Cuba;America Centro-Meridionale;America
58042;Genazzano;2;3;5;Bulgaria;Unione Europea;Europa
58042;Genazzano;1;3;4;Bangladesh;Asia Centro-Meridionale;Asia
58042;Genazzano;2;2;4;Congo, Repubblica democratica del (ex Zaire);Africa Centro-Meridionale;Africa
58042;Genazzano;1;3;4;Stati Uniti d'America;America Settentrionale;America
58042;Genazzano;3;0;3;Afghanistan;Asia Centro-Meridionale;Asia
58042;Genazzano;2;1;3;Brasile;America Centro-Meridionale;America
58042;Genazzano;0;3;3;Colombia;America Centro-Meridionale;America
58042;Genazzano;1;2;3;Francia;Unione Europea;Europa
58042;Genazzano;1;2;3;Germania;Unione Europea;Europa
58042;Genazzano;1;2;3;Giamaica;America Centro-Meridionale;America
58042;Genazzano;1;2;3;Perù;America Centro-Meridionale;America
58042;Genazzano;0;2;2;Portogallo;Unione Europea;Europa
58042;Genazzano;1;1;2;Slovacchia;Unione Europea;Europa
58042;Genazzano;1;0;1;Algeria;Africa Settentrionale;Africa
58042;Genazzano;1;0;1;Antigua e Barbuda;America Centro-Meridionale;America
58042;Genazzano;0;1;1;Austria;Unione Europea;Europa
58042;Genazzano;0;1;1;Camerun;Africa Centro-Meridionale;Africa
58042;Genazzano;0;1;1;Capo Verde;Africa Occidentale;Africa
58042;Genazzano;1;0;1;Croazia;Unione Europea;Europa
58042;Genazzano;0;1;1;Dominicana, Repubblica;America Centro-Meridionale;America
58042;Genazzano;0;1;1;Ecuador;America Centro-Meridionale;America
58042;Genazzano;1;0;1;Egitto;Africa Settentrionale;Africa
58042;Genazzano;0;1;1;Filippine;Asia Orientale;Asia
58042;Genazzano;1;0;1;Gabon;Africa Centro-Meridionale;Africa
58042;Genazzano;0;1;1;Grecia;Unione Europea;Europa
58042;Genazzano;0;1;1;India;Asia Centro-Meridionale;Asia
58042;Genazzano;1;0;1;Irlanda;Unione Europea;Europa
58042;Genazzano;0;1;1;Lettonia;Unione Europea;Europa
58042;Genazzano;1;0;1;Niger;Africa Occidentale;Africa
58042;Genazzano;1;0;1;Nuova Zelanda;Oceania;Oceania
58042;Genazzano;1;0;1;Paesi Bassi;Unione Europea;Europa
58042;Genazzano;1;0;1;Regno Unito;Altri paesi europei;Europa
58042;Genazzano;1;0;1;Senegal;Africa Occidentale;Africa
58042;Genazzano;0;1;1;Serbia, Repubblica di;Europa Centro-Orientale;Europa
58042;Genazzano;0;1;1;Spagna;Unione Europea;Europa
58042;Genazzano;1;0;1;Sudan;Africa Settentrionale;Africa
58042;Genazzano;1;0;1;Svizzera;Altri paesi europei;Europa
58042;Genazzano;0;1;1;Ungheria;Unione Europea;Europa
58042;Genazzano;0;1;1;Venezuela;America Centro-Meridionale;America
58043;Genzano di Roma;486;572;1058;Romania;Unione Europea;Europa
58043;Genzano di Roma;73;46;119;India;Asia Centro-Meridionale;Asia
58043;Genzano di Roma;43;49;92;Albania;Europa Centro-Orientale;Europa
58043;Genzano di Roma;38;15;53;Bangladesh;Asia Centro-Meridionale;Asia
58043;Genzano di Roma;22;26;48;Cinese, Repubblica Popolare;Asia Orientale;Asia
58043;Genzano di Roma;34;12;46;Egitto;Africa Settentrionale;Africa
58043;Genzano di Roma;6;40;46;Ucraina;Europa Centro-Orientale;Europa
58043;Genzano di Roma;14;19;33;Polonia;Unione Europea;Europa
58043;Genzano di Roma;17;9;26;Macedonia del Nord;Europa Centro-Orientale;Europa
58043;Genzano di Roma;19;7;26;Marocco;Africa Settentrionale;Africa
58043;Genzano di Roma;6;14;20;Filippine;Asia Orientale;Asia
58043;Genzano di Roma;6;13;19;Moldova;Europa Centro-Orientale;Europa
58043;Genzano di Roma;13;5;18;Tunisia;Africa Settentrionale;Africa
58043;Genzano di Roma;14;4;18;Turchia;Europa Centro-Orientale;Europa
58043;Genzano di Roma;7;10;17;Perù;America Centro-Meridionale;America
58043;Genzano di Roma;5;11;16;Brasile;America Centro-Meridionale;America
58043;Genzano di Roma;8;7;15;Algeria;Africa Settentrionale;Africa
58043;Genzano di Roma;3;11;14;Regno Unito;Altri paesi europei;Europa
58043;Genzano di Roma;9;3;12;Pakistan;Asia Centro-Meridionale;Asia
58043;Genzano di Roma;1;11;12;Stati Uniti d'America;America Settentrionale;America
58043;Genzano di Roma;1;10;11;Russa, Federazione;Europa Centro-Orientale;Europa
58043;Genzano di Roma;5;6;11;Spagna;Unione Europea;Europa
58043;Genzano di Roma;9;0;9;Afghanistan;Asia Centro-Meridionale;Asia
58043;Genzano di Roma;5;4;9;Germania;Unione Europea;Europa
58043;Genzano di Roma;4;3;7;Ecuador;America Centro-Meridionale;America
58043;Genzano di Roma;3;3;6;Kosovo;Europa Centro-Orientale;Europa
58043;Genzano di Roma;3;2;5;Burkina Faso (ex Alto Volta);Africa Occidentale;Africa
58043;Genzano di Roma;1;4;5;Ceca, Repubblica;Unione Europea;Europa
58043;Genzano di Roma;1;4;5;Congo (Repubblica del);Africa Centro-Meridionale;Africa
58043;Genzano di Roma;0;5;5;Cuba;America Centro-Meridionale;America
58043;Genzano di Roma;1;4;5;Francia;Unione Europea;Europa
58043;Genzano di Roma;3;2;5;Nigeria;Africa Occidentale;Africa
58043;Genzano di Roma;2;2;4;Cile;America Centro-Meridionale;America
58043;Genzano di Roma;2;2;4;Colombia;America Centro-Meridionale;America
58043;Genzano di Roma;0;4;4;Kenya;Africa Orientale;Africa
58043;Genzano di Roma;0;3;3;Belgio;Unione Europea;Europa
58043;Genzano di Roma;0;3;3;Bulgaria;Unione Europea;Europa
58043;Genzano di Roma;0;3;3;Congo, Repubblica democratica del (ex Zaire);Africa Centro-Meridionale;Africa
58043;Genzano di Roma;2;1;3;Croazia;Unione Europea;Europa
58043;Genzano di Roma;1;2;3;Sri Lanka (ex Ceylon);Asia Centro-Meridionale;Asia
58043;Genzano di Roma;0;2;2;Argentina;America Centro-Meridionale;America
58043;Genzano di Roma;0;2;2;Bielorussia;Europa Centro-Orientale;Europa
58043;Genzano di Roma;2;0;2;Gambia;Africa Occidentale;Africa
58043;Genzano di Roma;2;0;2;Ghana;Africa Occidentale;Africa
58043;Genzano di Roma;1;1;2;Iran, Repubblica Islamica del;Asia Occidentale;Asia
58043;Genzano di Roma;0;2;2;Norvegia;Altri paesi europei;Europa
58043;Genzano di Roma;0;2;2;Portogallo;Unione Europea;Europa
58043;Genzano di Roma;1;1;2;Ungheria;Unione Europea;Europa
58043;Genzano di Roma;1;0;1;Costa d'Avorio;Africa Occidentale;Africa
58043;Genzano di Roma;0;1;1;Danimarca;Unione Europea;Europa
58043;Genzano di Roma;0;1;1;Dominicana, Repubblica;America Centro-Meridionale;America
58043;Genzano di Roma;0;1;1;El Salvador;America Centro-Meridionale;America
58043;Genzano di Roma;1;0;1;Etiopia;Africa Orientale;Africa
58043;Genzano di Roma;0;1;1;Georgia;Asia Occidentale;Asia
58043;Genzano di Roma;0;1;1;Giappone;Asia Orientale;Asia
58043;Genzano di Roma;1;0;1;Grecia;Unione Europea;Europa
58043;Genzano di Roma;1;0;1;Iraq;Asia Occidentale;Asia
58043;Genzano di Roma;0;1;1;Israele;Asia Occidentale;Asia
58043;Genzano di Roma;0;1;1;Lettonia;Unione Europea;Europa
58043;Genzano di Roma;1;0;1;Libia;Africa Settentrionale;Africa
58043;Genzano di Roma;0;1;1;Madagascar;Africa Orientale;Africa
58043;Genzano di Roma;1;0;1;Mali;Africa Occidentale;Africa
58043;Genzano di Roma;0;1;1;Messico;America Centro-Meridionale;America
58043;Genzano di Roma;0;1;1;Montenegro;Europa Centro-Orientale;Europa
58043;Genzano di Roma;0;1;1;Nicaragua;America Centro-Meridionale;America
58043;Genzano di Roma;0;1;1;Panama;America Centro-Meridionale;America
58043;Genzano di Roma;0;1;1;Paraguay;America Centro-Meridionale;America
58043;Genzano di Roma;1;0;1;Senegal;Africa Occidentale;Africa
58043;Genzano di Roma;1;0;1;Serbia, Repubblica di;Europa Centro-Orientale;Europa
58043;Genzano di Roma;0;1;1;Svizzera;Altri paesi europei;Europa
58043;Genzano di Roma;0;1;1;Thailandia;Asia Orientale;Asia
58043;Genzano di Roma;0;1;1;Uruguay;America Centro-Meridionale;America
58043;Genzano di Roma;1;0;1;Vietnam;Asia Orientale;Asia
58044;Gerano;9;14;23;Romania;Unione Europea;Europa
58044;Gerano;5;4;9;Albania;Europa Centro-Orientale;Europa
58044;Gerano;5;3;8;Nigeria;Africa Occidentale;Africa
58044;Gerano;2;3;5;Francia;Unione Europea;Europa
58044;Gerano;1;3;4;Gambia;Africa Occidentale;Africa
58044;Gerano;2;2;4;Iraq;Asia Occidentale;Asia
58044;Gerano;2;2;4;Moldova;Europa Centro-Orientale;Europa
58044;Gerano;2;1;3;Azerbaigian;Asia Occidentale;Asia
58044;Gerano;1;2;3;Polonia;Unione Europea;Europa
58044;Gerano;1;1;2;Bulgaria;Unione Europea;Europa
58044;Gerano;0;2;2;Regno Unito;Altri paesi europei;Europa
58044;Gerano;0;2;2;Ucraina;Europa Centro-Orientale;Europa
58044;Gerano;1;0;1;Ceca, Repubblica;Unione Europea;Europa
58044;Gerano;0;1;1;Marocco;Africa Settentrionale;Africa
58044;Gerano;0;1;1;Stati Uniti d'America;America Settentrionale;America
58045;Gorga;19;19;38;Romania;Unione Europea;Europa
58045;Gorga;1;2;3;Brasile;America Centro-Meridionale;America
58045;Gorga;0;1;1;Moldova;Europa Centro-Orientale;Europa
58046;Grottaferrata;171;238;409;Romania;Unione Europea;Europa
58046;Grottaferrata;34;68;102;Perù;America Centro-Meridionale;America
58046;Grottaferrata;42;40;82;Albania;Europa Centro-Orientale;Europa
58046;Grottaferrata;26;49;75;Filippine;Asia Orientale;Asia
58046;Grottaferrata;19;53;72;Polonia;Unione Europea;Europa
58046;Grottaferrata;27;41;68;Moldova;Europa Centro-Orientale;Europa
58046;Grottaferrata;22;43;65;Ucraina;Europa Centro-Orientale;Europa
58046;Grottaferrata;6;50;56;India;Asia Centro-Meridionale;Asia
58046;Grottaferrata;9;38;47;Brasile;America Centro-Meridionale;America
58046;Grottaferrata;25;14;39;Bangladesh;Asia Centro-Meridionale;Asia
58046;Grottaferrata;1;34;35;Burkina Faso (ex Alto Volta);Africa Occidentale;Africa
58046;Grottaferrata;16;13;29;Cinese, Repubblica Popolare;Asia Orientale;Asia
58046;Grottaferrata;12;16;28;Francia;Unione Europea;Europa
58046;Grottaferrata;15;9;24;Egitto;Africa Settentrionale;Africa
58046;Grottaferrata;12;11;23;Germania;Unione Europea;Europa
58046;Grottaferrata;11;11;22;Sri Lanka (ex Ceylon);Asia Centro-Meridionale;Asia
58046;Grottaferrata;10;10;20;Regno Unito;Altri paesi europei;Europa
58046;Grottaferrata;3;16;19;Croazia;Unione Europea;Europa
58046;Grottaferrata;6;13;19;Spagna;Unione Europea;Europa
58046;Grottaferrata;4;14;18;Colombia;America Centro-Meridionale;America
58046;Grottaferrata;15;2;17;Pakistan;Asia Centro-Meridionale;Asia
58046;Grottaferrata;8;9;17;Portogallo;Unione Europea;Europa
58046;Grottaferrata;6;10;16;Stati Uniti d'America;America Settentrionale;America
58046;Grottaferrata;6;8;14;Bulgaria;Unione Europea;Europa
58046;Grottaferrata;3;11;14;Russa, Federazione;Europa Centro-Orientale;Europa
58046;Grottaferrata;4;7;11;Capo Verde;Africa Occidentale;Africa
58046;Grottaferrata;2;9;11;Messico;America Centro-Meridionale;America
58046;Grottaferrata;4;6;10;Venezuela;America Centro-Meridionale;America
58046;Grottaferrata;5;4;9;Australia;Oceania;Oceania
58046;Grottaferrata;1;8;9;Benin (ex Dahomey);Africa Occidentale;Africa
58046;Grottaferrata;2;6;8;Argentina;America Centro-Meridionale;America
58046;Grottaferrata;4;4;8;Irlanda;Unione Europea;Europa
58046;Grottaferrata;2;6;8;Mauritius;Africa Orientale;Africa
58046;Grottaferrata;4;4;8;Slovacchia;Unione Europea;Europa
58046;Grottaferrata;1;7;8;Svezia;Unione Europea;Europa
58046;Grottaferrata;5;3;8;Tunisia;Africa Settentrionale;Africa
58046;Grottaferrata;4;3;7;Nepal;Asia Centro-Meridionale;Asia
58046;Grottaferrata;6;1;7;Paesi Bassi;Unione Europea;Europa
58046;Grottaferrata;3;3;6;Belgio;Unione Europea;Europa
58046;Grottaferrata;3;3;6;Iraq;Asia Occidentale;Asia
58046;Grottaferrata;0;6;6;Togo;Africa Occidentale;Africa
58046;Grottaferrata;2;4;6;Ungheria;Unione Europea;Europa
58046;Grottaferrata;1;4;5;Corea, Repubblica (Corea del Sud);Asia Orientale;Asia
58046;Grottaferrata;1;4;5;Giappone;Asia Orientale;Asia
58046;Grottaferrata;4;1;5;Marocco;Africa Settentrionale;Africa
58046;Grottaferrata;1;4;5;Svizzera;Altri paesi europei;Europa
58046;Grottaferrata;1;3;4;Austria;Unione Europea;Europa
58046;Grottaferrata;1;3;4;Bielorussia;Europa Centro-Orientale;Europa
58046;Grottaferrata;0;4;4;Cuba;America Centro-Meridionale;America
58046;Grottaferrata;3;1;4;Danimarca;Unione Europea;Europa
58046;Grottaferrata;3;1;4;Ecuador;America Centro-Meridionale;America
58046;Grottaferrata;0;4;4;Georgia;Asia Occidentale;Asia
58046;Grottaferrata;1;3;4;Grecia;Unione Europea;Europa
58046;Grottaferrata;2;2;4;Libia;Africa Settentrionale;Africa
58046;Grottaferrata;2;2;4;Macedonia del Nord;Europa Centro-Orientale;Europa
58046;Grottaferrata;2;2;4;Malta;Unione Europea;Europa
58046;Grottaferrata;1;2;3;Bolivia;America Centro-Meridionale;America
58046;Grottaferrata;2;1;3;Burundi;Africa Orientale;Africa
58046;Grottaferrata;1;2;3;Canada;America Settentrionale;America
58046;Grottaferrata;1;2;3;Lituania;Unione Europea;Europa
58046;Grottaferrata;2;1;3;Nigeria;Africa Occidentale;Africa
58046;Grottaferrata;2;1;3;Norvegia;Altri paesi europei;Europa
58046;Grottaferrata;1;2;3;Serbia, Repubblica di;Europa Centro-Orientale;Europa
58046;Grottaferrata;1;2;3;Sud Africa;Africa Centro-Meridionale;Africa
58046;Grottaferrata;1;2;3;Zimbabwe (ex Rhodesia);Africa Orientale;Africa
58046;Grottaferrata;1;1;2;Camerun;Africa Centro-Meridionale;Africa
58046;Grottaferrata;0;2;2;Ceca, Repubblica;Unione Europea;Europa
58046;Grottaferrata;1;1;2;Costa d'Avorio;Africa Occidentale;Africa
58046;Grottaferrata;0;2;2;Etiopia;Africa Orientale;Africa
58046;Grottaferrata;1;1;2;Indonesia;Asia Orientale;Asia
58046;Grottaferrata;0;2;2;Iran, Repubblica Islamica del;Asia Occidentale;Asia
58046;Grottaferrata;0;2;2;Kazakhstan;Asia Centro-Meridionale;Asia
58046;Grottaferrata;0;2;2;Kenya;Africa Orientale;Africa
58046;Grottaferrata;0;2;2;Libano;Asia Occidentale;Asia
58046;Grottaferrata;0;2;2;Madagascar;Africa Orientale;Africa
58046;Grottaferrata;1;1;2;Mali;Africa Occidentale;Africa
58046;Grottaferrata;1;1;2;Niger;Africa Occidentale;Africa
58046;Grottaferrata;1;1;2;Paraguay;America Centro-Meridionale;America
58046;Grottaferrata;0;2;2;Slovenia;Unione Europea;Europa
58046;Grottaferrata;0;2;2;Thailandia;Asia Orientale;Asia
58046;Grottaferrata;0;1;1;Bosnia-Erzegovina;Europa Centro-Orientale;Europa
58046;Grottaferrata;0;1;1;Cile;America Centro-Meridionale;America
58046;Grottaferrata;0;1;1;Congo (Repubblica del);Africa Centro-Meridionale;Africa
58046;Grottaferrata;0;1;1;Congo, Repubblica democratica del (ex Zaire);Africa Centro-Meridionale;Africa
58046;Grottaferrata;1;0;1;Dominica;America Centro-Meridionale;America
58046;Grottaferrata;1;0;1;Dominicana, Repubblica;America Centro-Meridionale;America
58046;Grottaferrata;1;0;1;Estonia;Unione Europea;Europa
58046;Grottaferrata;1;0;1;Gambia;Africa Occidentale;Africa
58046;Grottaferrata;0;1;1;Guatemala;America Centro-Meridionale;America
58046;Grottaferrata;0;1;1;Mauritania;Africa Occidentale;Africa
58046;Grottaferrata;0;1;1;Myanmar (ex Birmania);Asia Orientale;Asia
58046;Grottaferrata;1;0;1;Nuova Zelanda;Oceania;Oceania
58046;Grottaferrata;0;1;1;Panama;America Centro-Meridionale;America
58046;Grottaferrata;1;0;1;Senegal;Africa Occidentale;Africa
58046;Grottaferrata;1;0;1;Uruguay;America Centro-Meridionale;America
58047;Guidonia Montecelio;3134;3352;6486;Romania;Unione Europea;Europa
58047;Guidonia Montecelio;533;142;675;Egitto;Africa Settentrionale;Africa
58047;Guidonia Montecelio;142;145;287;Cinese, Repubblica Popolare;Asia Orientale;Asia
58047;Guidonia Montecelio;135;137;272;Albania;Europa Centro-Orientale;Europa
58047;Guidonia Montecelio;192;43;235;Bangladesh;Asia Centro-Meridionale;Asia
58047;Guidonia Montecelio;106;120;226;Perù;America Centro-Meridionale;America
58047;Guidonia Montecelio;126;97;223;Marocco;Africa Settentrionale;Africa
58047;Guidonia Montecelio;67;116;183;Polonia;Unione Europea;Europa
58047;Guidonia Montecelio;102;76;178;Nigeria;Africa Occidentale;Africa
58047;Guidonia Montecelio;69;108;177;Moldova;Europa Centro-Orientale;Europa
58047;Guidonia Montecelio;38;120;158;Ucraina;Europa Centro-Orientale;Europa
58047;Guidonia Montecelio;92;46;138;Tunisia;Africa Settentrionale;Africa
58047;Guidonia Montecelio;74;16;90;Pakistan;Asia Centro-Meridionale;Asia
58047;Guidonia Montecelio;58;31;89;Ghana;Africa Occidentale;Africa
58047;Guidonia Montecelio;44;30;74;India;Asia Centro-Meridionale;Asia
58047;Guidonia Montecelio;29;43;72;Filippine;Asia Orientale;Asia
58047;Guidonia Montecelio;55;11;66;Somalia;Africa Orientale;Africa
58047;Guidonia Montecelio;35;29;64;Algeria;Africa Settentrionale;Africa
58047;Guidonia Montecelio;37;27;64;Macedonia del Nord;Europa Centro-Orientale;Europa
58047;Guidonia Montecelio;22;33;55;Ecuador;America Centro-Meridionale;America
58047;Guidonia Montecelio;16;37;53;Cuba;America Centro-Meridionale;America
58047;Guidonia Montecelio;18;32;50;Etiopia;Africa Orientale;Africa
58047;Guidonia Montecelio;43;6;49;Afghanistan;Asia Centro-Meridionale;Asia
58047;Guidonia Montecelio;15;34;49;Brasile;America Centro-Meridionale;America
58047;Guidonia Montecelio;21;24;45;Colombia;America Centro-Meridionale;America
58047;Guidonia Montecelio;25;18;43;Sri Lanka (ex Ceylon);Asia Centro-Meridionale;Asia
58047;Guidonia Montecelio;20;18;38;Iran, Repubblica Islamica del;Asia Occidentale;Asia
58047;Guidonia Montecelio;27;8;35;Iraq;Asia Occidentale;Asia
58047;Guidonia Montecelio;30;5;35;Senegal;Africa Occidentale;Africa
58047;Guidonia Montecelio;26;6;32;Eritrea;Africa Orientale;Africa
58047;Guidonia Montecelio;13;16;29;Bulgaria;Unione Europea;Europa
58047;Guidonia Montecelio;22;6;28;Burkina Faso (ex Alto Volta);Africa Occidentale;Africa
58047;Guidonia Montecelio;17;10;27;Corea, Repubblica (Corea del Sud);Asia Orientale;Asia
58047;Guidonia Montecelio;4;21;25;Russa, Federazione;Europa Centro-Orientale;Europa
58047;Guidonia Montecelio;24;0;24;Gambia;Africa Occidentale;Africa
58047;Guidonia Montecelio;21;3;24;Mali;Africa Occidentale;Africa
58047;Guidonia Montecelio;18;6;24;Turchia;Europa Centro-Orientale;Europa
58047;Guidonia Montecelio;12;10;22;Siria;Asia Occidentale;Asia
58047;Guidonia Montecelio;6;15;21;Francia;Unione Europea;Europa
58047;Guidonia Montecelio;12;9;21;Regno Unito;Altri paesi europei;Europa
58047;Guidonia Montecelio;5;15;20;Spagna;Unione Europea;Europa
58047;Guidonia Montecelio;8;10;18;Congo, Repubblica democratica del (ex Zaire);Africa Centro-Meridionale;Africa
58047;Guidonia Montecelio;8;9;17;Dominica;America Centro-Meridionale;America
58047;Guidonia Montecelio;7;10;17;Dominicana, Repubblica;America Centro-Meridionale;America
58047;Guidonia Montecelio;5;12;17;El Salvador;America Centro-Meridionale;America
58047;Guidonia Montecelio;4;12;16;Germania;Unione Europea;Europa
58047;Guidonia Montecelio;15;0;15;Guinea;Africa Occidentale;Africa
58047;Guidonia Montecelio;12;3;15;Messico;America Centro-Meridionale;America
58047;Guidonia Montecelio;4;10;14;Honduras;America Centro-Meridionale;America
58047;Guidonia Montecelio;4;10;14;Venezuela;America Centro-Meridionale;America
58047;Guidonia Montecelio;7;6;13;Costa d'Avorio;Africa Occidentale;Africa
58047;Guidonia Montecelio;2;11;13;Croazia;Unione Europea;Europa
58047;Guidonia Montecelio;5;8;13;Togo;Africa Occidentale;Africa
58047;Guidonia Montecelio;3;9;12;Bielorussia;Europa Centro-Orientale;Europa
58047;Guidonia Montecelio;5;7;12;Bolivia;America Centro-Meridionale;America
58047;Guidonia Montecelio;3;9;12;Georgia;Asia Occidentale;Asia
58047;Guidonia Montecelio;1;10;11;Capo Verde;Africa Occidentale;Africa
58047;Guidonia Montecelio;6;5;11;Kosovo;Europa Centro-Orientale;Europa
58047;Guidonia Montecelio;5;6;11;Serbia, Repubblica di;Europa Centro-Orientale;Europa
58047;Guidonia Montecelio;6;4;10;Camerun;Africa Centro-Meridionale;Africa
58047;Guidonia Montecelio;1;8;9;Portogallo;Unione Europea;Europa
58047;Guidonia Montecelio;3;5;8;Armenia;Asia Occidentale;Asia
58047;Guidonia Montecelio;2;6;8;Belgio;Unione Europea;Europa
58047;Guidonia Montecelio;3;5;8;Grecia;Unione Europea;Europa
58047;Guidonia Montecelio;2;6;8;Paesi Bassi;Unione Europea;Europa
58047;Guidonia Montecelio;1;7;8;Stati Uniti d'America;America Settentrionale;America
58047;Guidonia Montecelio;4;3;7;Angola;Africa Centro-Meridionale;Africa
58047;Guidonia Montecelio;3;4;7;Bosnia-Erzegovina;Europa Centro-Orientale;Europa
58047;Guidonia Montecelio;7;0;7;Libia;Africa Settentrionale;Africa
58047;Guidonia Montecelio;3;3;6;Congo (Repubblica del);Africa Centro-Meridionale;Africa
58047;Guidonia Montecelio;1;5;6;Giordania;Asia Occidentale;Asia
58047;Guidonia Montecelio;4;2;6;Libano;Asia Occidentale;Asia
58047;Guidonia Montecelio;4;2;6;Montenegro;Europa Centro-Orientale;Europa
58047;Guidonia Montecelio;4;2;6;Mozambico;Africa Orientale;Africa
58047;Guidonia Montecelio;2;4;6;San Marino;Altri paesi europei;Europa
58047;Guidonia Montecelio;2;3;5;Argentina;America Centro-Meridionale;America
58047;Guidonia Montecelio;4;1;5;Territori dell'Autonomia Palestinese;Asia Occidentale;Asia
58047;Guidonia Montecelio;2;3;5;Thailandia;Asia Orientale;Asia
58047;Guidonia Montecelio;1;3;4;Austria;Unione Europea;Europa
58047;Guidonia Montecelio;1;3;4;Ceca, Repubblica;Unione Europea;Europa
58047;Guidonia Montecelio;0;4;4;Lettonia;Unione Europea;Europa
58047;Guidonia Montecelio;1;3;4;Paraguay;America Centro-Meridionale;America
58047;Guidonia Montecelio;0;4;4;Slovacchia;Unione Europea;Europa
58047;Guidonia Montecelio;2;2;4;Stato della Città del Vaticano;Altri paesi europei;Europa
58047;Guidonia Montecelio;1;2;3;Benin (ex Dahomey);Africa Occidentale;Africa
58047;Guidonia Montecelio;1;2;3;Nicaragua;America Centro-Meridionale;America
58047;Guidonia Montecelio;3;0;3;Sudan;Africa Settentrionale;Africa
58047;Guidonia Montecelio;0;3;3;Svezia;Unione Europea;Europa
58047;Guidonia Montecelio;2;1;3;Tanzania;Africa Orientale;Africa
58047;Guidonia Montecelio;3;0;3;Uruguay;America Centro-Meridionale;America
58047;Guidonia Montecelio;1;1;2;Canada;America Settentrionale;America
58047;Guidonia Montecelio;1;1;2;Gabon;Africa Centro-Meridionale;Africa
58047;Guidonia Montecelio;1;1;2;Giappone;Asia Orientale;Asia
58047;Guidonia Montecelio;2;0;2;Guinea Bissau;Africa Occidentale;Africa
58047;Guidonia Montecelio;0;2;2;Indonesia;Asia Orientale;Asia
58047;Guidonia Montecelio;0;2;2;Kazakhstan;Asia Centro-Meridionale;Asia
58047;Guidonia Montecelio;1;1;2;Kenya;Africa Orientale;Africa
58047;Guidonia Montecelio;0;2;2;Lituania;Unione Europea;Europa
58047;Guidonia Montecelio;1;1;2;Niger;Africa Occidentale;Africa
58047;Guidonia Montecelio;2;0;2;Sierra Leone;Africa Occidentale;Africa
58047;Guidonia Montecelio;1;1;2;Sud Africa;Africa Centro-Meridionale;Africa
58047;Guidonia Montecelio;0;2;2;Uganda;Africa Orientale;Africa
58047;Guidonia Montecelio;1;0;1;Australia;Oceania;Oceania
58047;Guidonia Montecelio;0;1;1;Azerbaigian;Asia Occidentale;Asia
58047;Guidonia Montecelio;0;1;1;Centrafricana, Repubblica;Africa Centro-Meridionale;Africa
58047;Guidonia Montecelio;1;0;1;Cile;America Centro-Meridionale;America
58047;Guidonia Montecelio;0;1;1;Costa Rica;America Centro-Meridionale;America
58047;Guidonia Montecelio;0;1;1;Finlandia;Unione Europea;Europa
58047;Guidonia Montecelio;0;1;1;Guatemala;America Centro-Meridionale;America
58047;Guidonia Montecelio;0;1;1;Haiti;America Centro-Meridionale;America
58047;Guidonia Montecelio;0;1;1;Israele;Asia Occidentale;Asia
58047;Guidonia Montecelio;1;0;1;Liberia;Africa Occidentale;Africa
58047;Guidonia Montecelio;0;1;1;Mauritius;Africa Orientale;Africa
58047;Guidonia Montecelio;1;0;1;Myanmar (ex Birmania);Asia Orientale;Asia
58047;Guidonia Montecelio;0;1;1;Panama;America Centro-Meridionale;America
58047;Guidonia Montecelio;0;1;1;Slovenia;Unione Europea;Europa
58047;Guidonia Montecelio;1;0;1;Sud Sudan, Repubblica del;Africa Settentrionale;Africa
58047;Guidonia Montecelio;0;1;1;Svizzera;Altri paesi europei;Europa
58047;Guidonia Montecelio;0;1;1;Ungheria;Unione Europea;Europa
58048;Jenne;0;2;2;Romania;Unione Europea;Europa
58048;Jenne;0;1;1;Venezuela;America Centro-Meridionale;America
58049;Labico;200;198;398;Romania;Unione Europea;Europa
58049;Labico;20;15;35;Albania;Europa Centro-Orientale;Europa
58049;Labico;17;8;25;Nigeria;Africa Occidentale;Africa
58049;Labico;7;13;20;Polonia;Unione Europea;Europa
58049;Labico;6;7;13;Brasile;America Centro-Meridionale;America
58049;Labico;6;6;12;Bulgaria;Unione Europea;Europa
58049;Labico;3;7;10;Moldova;Europa Centro-Orientale;Europa
58049;Labico;1;9;10;Ucraina;Europa Centro-Orientale;Europa
58049;Labico;4;5;9;Iran, Repubblica Islamica del;Asia Occidentale;Asia
58049;Labico;4;4;8;Ecuador;America Centro-Meridionale;America
58049;Labico;3;4;7;Francia;Unione Europea;Europa
58049;Labico;3;3;6;Pakistan;Asia Centro-Meridionale;Asia
58049;Labico;1;4;5;Kosovo;Europa Centro-Orientale;Europa
58049;Labico;3;1;4;Bangladesh;Asia Centro-Meridionale;Asia
58049;Labico;1;3;4;Colombia;America Centro-Meridionale;America
58049;Labico;3;1;4;Ghana;Africa Occidentale;Africa
58049;Labico;3;1;4;Somalia;Africa Orientale;Africa
58049;Labico;2;2;4;Spagna;Unione Europea;Europa
58049;Labico;0;3;3;Bielorussia;Europa Centro-Orientale;Europa
58049;Labico;2;1;3;Capo Verde;Africa Occidentale;Africa
58049;Labico;2;1;3;Costa d'Avorio;Africa Occidentale;Africa
58049;Labico;1;2;3;Portogallo;Unione Europea;Europa
58049;Labico;1;2;3;Senegal;Africa Occidentale;Africa
58049;Labico;3;0;3;Siria;Asia Occidentale;Asia
58049;Labico;1;2;3;Turchia;Europa Centro-Orientale;Europa
58049;Labico;2;1;3;Venezuela;America Centro-Meridionale;America
58049;Labico;1;1;2;Camerun;Africa Centro-Meridionale;Africa
58049;Labico;0;2;2;Dominicana, Repubblica;America Centro-Meridionale;America
58049;Labico;1;1;2;Kazakhstan;Asia Centro-Meridionale;Asia
58049;Labico;0;2;2;Macedonia del Nord;Europa Centro-Orientale;Europa
58049;Labico;0;2;2;Marocco;Africa Settentrionale;Africa
58049;Labico;1;1;2;Perù;America Centro-Meridionale;America
58049;Labico;0;1;1;Bolivia;America Centro-Meridionale;America
58049;Labico;0;1;1;Cinese, Repubblica Popolare;Asia Orientale;Asia
58049;Labico;1;0;1;Congo (Repubblica del);Africa Centro-Meridionale;Africa
58049;Labico;0;1;1;Cuba;America Centro-Meridionale;America
58049;Labico;1;0;1;Egitto;Africa Settentrionale;Africa
58049;Labico;0;1;1;Filippine;Asia Orientale;Asia
58049;Labico;0;1;1;Lettonia;Unione Europea;Europa
58049;Labico;1;0;1;Libano;Asia Occidentale;Asia
58049;Labico;1;0;1;Messico;America Centro-Meridionale;America
58049;Labico;0;1;1;Russa, Federazione;Europa Centro-Orientale;Europa
58049;Labico;1;0;1;Sierra Leone;Africa Occidentale;Africa
58049;Labico;1;0;1;Tunisia;Africa Settentrionale;Africa
58049;Labico;1;0;1;Ungheria;Unione Europea;Europa
58049;Labico;0;1;1;Zimbabwe (ex Rhodesia);Africa Orientale;Africa
58116;Ladispoli;1858;1974;3832;Romania;Unione Europea;Europa
58116;Ladispoli;258;112;370;India;Asia Centro-Meridionale;Asia
58116;Ladispoli;133;236;369;Polonia;Unione Europea;Europa
58116;Ladispoli;174;52;226;Senegal;Africa Occidentale;Africa
58116;Ladispoli;72;154;226;Ucraina;Europa Centro-Orientale;Europa
58116;Ladispoli;60;105;165;Moldova;Europa Centro-Orientale;Europa
58116;Ladispoli;88;39;127;Marocco;Africa Settentrionale;Africa
58116;Ladispoli;50;70;120;Bulgaria;Unione Europea;Europa
58116;Ladispoli;52;44;96;Albania;Europa Centro-Orientale;Europa
58116;Ladispoli;52;41;93;Cinese, Repubblica Popolare;Asia Orientale;Asia
58116;Ladispoli;73;16;89;Egitto;Africa Settentrionale;Africa
58116;Ladispoli;59;22;81;Nigeria;Africa Occidentale;Africa
58116;Ladispoli;29;50;79;Filippine;Asia Orientale;Asia
58116;Ladispoli;27;35;62;Perù;America Centro-Meridionale;America
58116;Ladispoli;40;12;52;Bangladesh;Asia Centro-Meridionale;Asia
58116;Ladispoli;12;37;49;Russa, Federazione;Europa Centro-Orientale;Europa
58116;Ladispoli;9;34;43;Brasile;America Centro-Meridionale;America
58116;Ladispoli;18;21;39;Ecuador;America Centro-Meridionale;America
58116;Ladispoli;20;7;27;Tunisia;Africa Settentrionale;Africa
58116;Ladispoli;16;9;25;Libia;Africa Settentrionale;Africa
58116;Ladispoli;7;17;24;Cuba;America Centro-Meridionale;America
58116;Ladispoli;15;9;24;Pakistan;Asia Centro-Meridionale;Asia
58116;Ladispoli;16;8;24;Turchia;Europa Centro-Orientale;Europa
58116;Ladispoli;14;9;23;Algeria;Africa Settentrionale;Africa
58116;Ladispoli;6;14;20;Colombia;America Centro-Meridionale;America
58116;Ladispoli;5;15;20;Spagna;Unione Europea;Europa
58116;Ladispoli;5;12;17;Argentina;America Centro-Meridionale;America
58116;Ladispoli;9;6;15;Sri Lanka (ex Ceylon);Asia Centro-Meridionale;Asia
58116;Ladispoli;5;9;14;El Salvador;America Centro-Meridionale;America
58116;Ladispoli;9;2;11;Libano;Asia Occidentale;Asia
58116;Ladispoli;3;7;10;Francia;Unione Europea;Europa
58116;Ladispoli;6;4;10;Macedonia del Nord;Europa Centro-Orientale;Europa
58116;Ladispoli;6;4;10;Stati Uniti d'America;America Settentrionale;America
58116;Ladispoli;0;9;9;Germania;Unione Europea;Europa
58116;Ladispoli;3;6;9;Kenya;Africa Orientale;Africa
58116;Ladispoli;4;5;9;Portogallo;Unione Europea;Europa
58116;Ladispoli;7;2;9;Regno Unito;Altri paesi europei;Europa
58116;Ladispoli;3;6;9;Venezuela;America Centro-Meridionale;America
58116;Ladispoli;6;2;8;Afghanistan;Asia Centro-Meridionale;Asia
58116;Ladispoli;1;7;8;Bielorussia;Europa Centro-Orientale;Europa
58116;Ladispoli;1;7;8;Georgia;Asia Occidentale;Asia
58116;Ladispoli;1;7;8;Ungheria;Unione Europea;Europa
58116;Ladispoli;4;3;7;Camerun;Africa Centro-Meridionale;Africa
58116;Ladispoli;3;4;7;Cile;America Centro-Meridionale;America
58116;Ladispoli;1;6;7;Giappone;Asia Orientale;Asia
58116;Ladispoli;2;5;7;Iran, Repubblica Islamica del;Asia Occidentale;Asia
58116;Ladispoli;1;5;6;Austria;Unione Europea;Europa
58116;Ladispoli;1;5;6;Mauritius;Africa Orientale;Africa
58116;Ladispoli;0;6;6;Svezia;Unione Europea;Europa
58116;Ladispoli;3;2;5;Costa d'Avorio;Africa Occidentale;Africa
58116;Ladispoli;4;1;5;Ghana;Africa Occidentale;Africa
58116;Ladispoli;3;2;5;Lettonia;Unione Europea;Europa
58116;Ladispoli;1;4;5;Messico;America Centro-Meridionale;America
58116;Ladispoli;4;1;5;Norvegia;Altri paesi europei;Europa
58116;Ladispoli;0;5;5;Slovacchia;Unione Europea;Europa
58116;Ladispoli;2;3;5;Svizzera;Altri paesi europei;Europa
58116;Ladispoli;2;3;5;Territori dell'Autonomia Palestinese;Asia Occidentale;Asia
58116;Ladispoli;1;3;4;Belgio;Unione Europea;Europa
58116;Ladispoli;2;2;4;Canada;America Settentrionale;America
58116;Ladispoli;2;2;4;Grecia;Unione Europea;Europa
58116;Ladispoli;0;3;3;Congo (Repubblica del);Africa Centro-Meridionale;Africa
58116;Ladispoli;0;3;3;Congo, Repubblica democratica del (ex Zaire);Africa Centro-Meridionale;Africa
58116;Ladispoli;3;0;3;Giordania;Asia Occidentale;Asia
58116;Ladispoli;1;2;3;Guatemala;America Centro-Meridionale;America
58116;Ladispoli;3;0;3;Mauritania;Africa Occidentale;Africa
58116;Ladispoli;1;2;3;Siria;Asia Occidentale;Asia
58116;Ladispoli;1;2;3;Uruguay;America Centro-Meridionale;America
58116;Ladispoli;1;1;2;Bosnia-Erzegovina;Europa Centro-Orientale;Europa
58116;Ladispoli;1;1;2;Capo Verde;Africa Occidentale;Africa
58116;Ladispoli;0;2;2;Ceca, Repubblica;Unione Europea;Europa
58116;Ladispoli;0;2;2;Corea, Repubblica (Corea del Sud);Asia Orientale;Asia
58116;Ladispoli;2;0;2;Dominicana, Repubblica;America Centro-Meridionale;America
58116;Ladispoli;0;2;2;Finlandia;Unione Europea;Europa
58116;Ladispoli;0;2;2;Indonesia;Asia Orientale;Asia
58116;Ladispoli;0;2;2;Kazakhstan;Asia Centro-Meridionale;Asia
58116;Ladispoli;0;2;2;Thailandia;Asia Orientale;Asia
58116;Ladispoli;1;1;2;Uzbekistan;Asia Centro-Meridionale;Asia
58116;Ladispoli;0;1;1;Angola;Africa Centro-Meridionale;Africa
58116;Ladispoli;0;1;1;Bolivia;America Centro-Meridionale;America
58116;Ladispoli;1;0;1;Burundi;Africa Orientale;Africa
58116;Ladispoli;0;1;1;Croazia;Unione Europea;Europa
58116;Ladispoli;0;1;1;Danimarca;Unione Europea;Europa
58116;Ladispoli;0;1;1;Dominica;America Centro-Meridionale;America
58116;Ladispoli;1;0;1;Guinea;Africa Occidentale;Africa
58116;Ladispoli;0;1;1;Honduras;America Centro-Meridionale;America
58116;Ladispoli;1;0;1;Irlanda;Unione Europea;Europa
58116;Ladispoli;1;0;1;Israele;Asia Occidentale;Asia
58116;Ladispoli;0;1;1;Lituania;Unione Europea;Europa
58116;Ladispoli;0;1;1;Lussemburgo;Unione Europea;Europa
58116;Ladispoli;0;1;1;Madagascar;Africa Orientale;Africa
58116;Ladispoli;0;1;1;Malaysia;Asia Orientale;Asia
58116;Ladispoli;1;0;1;Mali;Africa Occidentale;Africa
58116;Ladispoli;0;1;1;Paesi Bassi;Unione Europea;Europa
58116;Ladispoli;0;1;1;Paraguay;America Centro-Meridionale;America
58116;Ladispoli;1;0;1;Ruanda;Africa Orientale;Africa
58116;Ladispoli;0;1;1;Slovenia;Unione Europea;Europa
58116;Ladispoli;1;0;1;Sudan;Africa Settentrionale;Africa
58116;Ladispoli;0;1;1;Togo;Africa Occidentale;Africa
58116;Ladispoli;1;0;1;Uganda;Africa Orientale;Africa
58116;Ladispoli;0;1;1;Zambia;Africa Orientale;Africa
58116;Ladispoli;0;1;1;Zimbabwe (ex Rhodesia);Africa Orientale;Africa
58050;Lanuvio;452;447;899;Romania;Unione Europea;Europa
58050;Lanuvio;52;18;70;India;Asia Centro-Meridionale;Asia
58050;Lanuvio;21;5;26;Egitto;Africa Settentrionale;Africa
58050;Lanuvio;6;18;24;Ucraina;Europa Centro-Orientale;Europa
58050;Lanuvio;6;17;23;Polonia;Unione Europea;Europa
58050;Lanuvio;9;10;19;Cinese, Repubblica Popolare;Asia Orientale;Asia
58050;Lanuvio;9;5;14;Albania;Europa Centro-Orientale;Europa
58050;Lanuvio;2;11;13;Brasile;America Centro-Meridionale;America
58050;Lanuvio;7;5;12;Marocco;Africa Settentrionale;Africa
58050;Lanuvio;8;3;11;Afghanistan;Asia Centro-Meridionale;Asia
58050;Lanuvio;8;3;11;Tunisia;Africa Settentrionale;Africa
58050;Lanuvio;3;7;10;Moldova;Europa Centro-Orientale;Europa
58050;Lanuvio;5;4;9;Capo Verde;Africa Occidentale;Africa
58050;Lanuvio;3;5;8;Macedonia del Nord;Europa Centro-Orientale;Europa
58050;Lanuvio;2;5;7;Germania;Unione Europea;Europa
58050;Lanuvio;5;2;7;Regno Unito;Altri paesi europei;Europa
58050;Lanuvio;2;4;6;Cuba;America Centro-Meridionale;America
58050;Lanuvio;2;3;5;Francia;Unione Europea;Europa
58050;Lanuvio;4;1;5;Senegal;Africa Occidentale;Africa
58050;Lanuvio;2;2;4;Bulgaria;Unione Europea;Europa
58050;Lanuvio;1;3;4;Etiopia;Africa Orientale;Africa
58050;Lanuvio;1;3;4;Filippine;Asia Orientale;Asia
58050;Lanuvio;2;2;4;Perù;America Centro-Meridionale;America
58050;Lanuvio;1;2;3;Benin (ex Dahomey);Africa Occidentale;Africa
58050;Lanuvio;1;2;3;Burkina Faso (ex Alto Volta);Africa Occidentale;Africa
58050;Lanuvio;1;2;3;Indonesia;Asia Orientale;Asia
58050;Lanuvio;1;2;3;Venezuela;America Centro-Meridionale;America
58050;Lanuvio;1;1;2;Algeria;Africa Settentrionale;Africa
58050;Lanuvio;0;2;2;Austria;Unione Europea;Europa
58050;Lanuvio;2;0;2;Danimarca;Unione Europea;Europa
58050;Lanuvio;1;1;2;Giappone;Asia Orientale;Asia
58050;Lanuvio;0;2;2;Kazakhstan;Asia Centro-Meridionale;Asia
58050;Lanuvio;2;0;2;Libano;Asia Occidentale;Asia
58050;Lanuvio;1;1;2;Nigeria;Africa Occidentale;Africa
58050;Lanuvio;1;1;2;Paesi Bassi;Unione Europea;Europa
58050;Lanuvio;2;0;2;Pakistan;Asia Centro-Meridionale;Asia
58050;Lanuvio;1;1;2;Svizzera;Altri paesi europei;Europa
58050;Lanuvio;0;2;2;Thailandia;Asia Orientale;Asia
58050;Lanuvio;1;0;1;Argentina;America Centro-Meridionale;America
58050;Lanuvio;1;0;1;Australia;Oceania;Oceania
58050;Lanuvio;1;0;1;Bangladesh;Asia Centro-Meridionale;Asia
58050;Lanuvio;1;0;1;Belgio;Unione Europea;Europa
58050;Lanuvio;0;1;1;Bielorussia;Europa Centro-Orientale;Europa
58050;Lanuvio;1;0;1;Bosnia-Erzegovina;Europa Centro-Orientale;Europa
58050;Lanuvio;0;1;1;Camerun;Africa Centro-Meridionale;Africa
58050;Lanuvio;1;0;1;Costa d'Avorio;Africa Occidentale;Africa
58050;Lanuvio;0;1;1;Ecuador;America Centro-Meridionale;America
58050;Lanuvio;1;0;1;Eritrea;Africa Orientale;Africa
58050;Lanuvio;0;1;1;Finlandia;Unione Europea;Europa
58050;Lanuvio;0;1;1;Giamaica;America Centro-Meridionale;America
58050;Lanuvio;1;0;1;Grecia;Unione Europea;Europa
58050;Lanuvio;0;1;1;Haiti;America Centro-Meridionale;America
58050;Lanuvio;0;1;1;Iran, Repubblica Islamica del;Asia Occidentale;Asia
58050;Lanuvio;1;0;1;Iraq;Asia Occidentale;Asia
58050;Lanuvio;0;1;1;Lettonia;Unione Europea;Europa
58050;Lanuvio;0;1;1;Mauritius;Africa Orientale;Africa
58050;Lanuvio;0;1;1;Messico;America Centro-Meridionale;America
58050;Lanuvio;1;0;1;Portogallo;Unione Europea;Europa
58050;Lanuvio;0;1;1;Russa, Federazione;Europa Centro-Orientale;Europa
58050;Lanuvio;0;1;1;Somalia;Africa Orientale;Africa
58050;Lanuvio;0;1;1;Stati Uniti d'America;America Settentrionale;America
58050;Lanuvio;1;0;1;Togo;Africa Occidentale;Africa
58115;Lariano;204;258;462;Romania;Unione Europea;Europa
58115;Lariano;78;37;115;Marocco;Africa Settentrionale;Africa
58115;Lariano;12;15;27;Albania;Europa Centro-Orientale;Europa
58115;Lariano;13;5;18;India;Asia Centro-Meridionale;Asia
58115;Lariano;16;1;17;Egitto;Africa Settentrionale;Africa
58115;Lariano;12;5;17;Tunisia;Africa Settentrionale;Africa
58115;Lariano;8;7;15;Cinese, Repubblica Popolare;Asia Orientale;Asia
58115;Lariano;5;7;12;Polonia;Unione Europea;Europa
58115;Lariano;3;8;11;Moldova;Europa Centro-Orientale;Europa
58115;Lariano;0;11;11;Ucraina;Europa Centro-Orientale;Europa
58115;Lariano;3;7;10;Russa, Federazione;Europa Centro-Orientale;Europa
58115;Lariano;2;3;5;Bielorussia;Europa Centro-Orientale;Europa
58115;Lariano;3;2;5;Francia;Unione Europea;Europa
58115;Lariano;3;2;5;Nigeria;Africa Occidentale;Africa
58115;Lariano;1;3;4;Cuba;America Centro-Meridionale;America
58115;Lariano;2;1;3;Argentina;America Centro-Meridionale;America
58115;Lariano;3;0;3;Bangladesh;Asia Centro-Meridionale;Asia
58115;Lariano;0;3;3;Brasile;America Centro-Meridionale;America
58115;Lariano;2;1;3;Etiopia;Africa Orientale;Africa
58115;Lariano;0;3;3;Germania;Unione Europea;Europa
58115;Lariano;1;2;3;Macedonia del Nord;Europa Centro-Orientale;Europa
58115;Lariano;0;3;3;Perù;America Centro-Meridionale;America
58115;Lariano;1;1;2;Belgio;Unione Europea;Europa
58115;Lariano;0;2;2;Colombia;America Centro-Meridionale;America
58115;Lariano;1;1;2;Filippine;Asia Orientale;Asia
58115;Lariano;0;2;2;Spagna;Unione Europea;Europa
58115;Lariano;1;1;2;Stati Uniti d'America;America Settentrionale;America
58115;Lariano;1;1;2;Venezuela;America Centro-Meridionale;America
58115;Lariano;0;1;1;Algeria;Africa Settentrionale;Africa
58115;Lariano;1;0;1;Australia;Oceania;Oceania
58115;Lariano;0;1;1;Austria;Unione Europea;Europa
58115;Lariano;1;0;1;Bulgaria;Unione Europea;Europa
58115;Lariano;0;1;1;Canada;America Settentrionale;America
58115;Lariano;1;0;1;Capo Verde;Africa Occidentale;Africa
58115;Lariano;0;1;1;Ceca, Repubblica;Unione Europea;Europa
58115;Lariano;1;0;1;Costa d'Avorio;Africa Occidentale;Africa
58115;Lariano;0;1;1;Ecuador;America Centro-Meridionale;America
58115;Lariano;0;1;1;El Salvador;America Centro-Meridionale;America
58115;Lariano;0;1;1;Giappone;Asia Orientale;Asia
58115;Lariano;1;0;1;Iran, Repubblica Islamica del;Asia Occidentale;Asia
58115;Lariano;0;1;1;Mauritius;Africa Orientale;Africa
58115;Lariano;1;0;1;Portogallo;Unione Europea;Europa
58115;Lariano;0;1;1;Regno Unito;Altri paesi europei;Europa
58115;Lariano;1;0;1;Senegal;Africa Occidentale;Africa
58115;Lariano;1;0;1;Sri Lanka (ex Ceylon);Asia Centro-Meridionale;Asia
58115;Lariano;0;1;1;Thailandia;Asia Orientale;Asia
58115;Lariano;0;1;1;Zimbabwe (ex Rhodesia);Africa Orientale;Africa
58051;Licenza;34;30;64;Romania;Unione Europea;Europa
58051;Licenza;5;3;8;Albania;Europa Centro-Orientale;Europa
58051;Licenza;0;3;3;Bulgaria;Unione Europea;Europa
58051;Licenza;1;1;2;Sri Lanka (ex Ceylon);Asia Centro-Meridionale;Asia
58051;Licenza;0;1;1;Argentina;America Centro-Meridionale;America
58051;Licenza;1;0;1;Azerbaigian;Asia Occidentale;Asia
58051;Licenza;0;1;1;Filippine;Asia Orientale;Asia
58051;Licenza;0;1;1;Georgia;Asia Occidentale;Asia
58051;Licenza;0;1;1;Tunisia;Africa Settentrionale;Africa
58051;Licenza;0;1;1;Venezuela;America Centro-Meridionale;America
58052;Magliano Romano;62;67;129;Romania;Unione Europea;Europa
58052;Magliano Romano;6;5;11;Albania;Europa Centro-Orientale;Europa
58052;Magliano Romano;2;6;8;Polonia;Unione Europea;Europa
58052;Magliano Romano;2;5;7;Kosovo;Europa Centro-Orientale;Europa
58052;Magliano Romano;6;0;6;Tunisia;Africa Settentrionale;Africa
58052;Magliano Romano;2;3;5;Filippine;Asia Orientale;Asia
58052;Magliano Romano;1;3;4;Ucraina;Europa Centro-Orientale;Europa
58052;Magliano Romano;1;2;3;Bulgaria;Unione Europea;Europa
58052;Magliano Romano;2;1;3;India;Asia Centro-Meridionale;Asia
58052;Magliano Romano;0;2;2;Cuba;America Centro-Meridionale;America
58052;Magliano Romano;1;1;2;Serbia, Repubblica di;Europa Centro-Orientale;Europa
58052;Magliano Romano;0;1;1;Brasile;America Centro-Meridionale;America
58052;Magliano Romano;0;1;1;El Salvador;America Centro-Meridionale;America
58052;Magliano Romano;0;1;1;Georgia;Asia Occidentale;Asia
58052;Magliano Romano;1;0;1;Giamaica;America Centro-Meridionale;America
58052;Magliano Romano;1;0;1;Macedonia del Nord;Europa Centro-Orientale;Europa
58052;Magliano Romano;1;0;1;Malta;Unione Europea;Europa
58052;Magliano Romano;1;0;1;Marocco;Africa Settentrionale;Africa
58052;Magliano Romano;0;1;1;Moldova;Europa Centro-Orientale;Europa
58052;Magliano Romano;0;1;1;Russa, Federazione;Europa Centro-Orientale;Europa
58052;Magliano Romano;1;0;1;Somalia;Africa Orientale;Africa
58052;Magliano Romano;1;0;1;Spagna;Unione Europea;Europa
58052;Magliano Romano;0;1;1;Venezuela;America Centro-Meridionale;America
58053;Mandela;32;33;65;Romania;Unione Europea;Europa
58053;Mandela;3;2;5;Gambia;Africa Occidentale;Africa
58053;Mandela;3;1;4;Ucraina;Europa Centro-Orientale;Europa
58053;Mandela;3;0;3;El Salvador;America Centro-Meridionale;America
58053;Mandela;2;0;2;Egitto;Africa Settentrionale;Africa
58053;Mandela;1;1;2;Regno Unito;Altri paesi europei;Europa
58053;Mandela;0;1;1;Austria;Unione Europea;Europa
58053;Mandela;0;1;1;Camerun;Africa Centro-Meridionale;Africa
58053;Mandela;0;1;1;Francia;Unione Europea;Europa
58053;Mandela;0;1;1;Germania;Unione Europea;Europa
58053;Mandela;0;1;1;Perù;America Centro-Meridionale;America
58053;Mandela;0;1;1;Russa, Federazione;Europa Centro-Orientale;Europa
58053;Mandela;0;1;1;Stati Uniti d'America;America Settentrionale;America
58053;Mandela;0;1;1;Tunisia;Africa Settentrionale;Africa
58054;Manziana;97;131;228;Romania;Unione Europea;Europa
58054;Manziana;31;32;63;Albania;Europa Centro-Orientale;Europa
58054;Manziana;11;24;35;Ucraina;Europa Centro-Orientale;Europa
58054;Manziana;12;16;28;Moldova;Europa Centro-Orientale;Europa
58054;Manziana;12;13;25;Sri Lanka (ex Ceylon);Asia Centro-Meridionale;Asia
58054;Manziana;7;15;22;Polonia;Unione Europea;Europa
58054;Manziana;7;14;21;Regno Unito;Altri paesi europei;Europa
58054;Manziana;16;4;20;Egitto;Africa Settentrionale;Africa
58054;Manziana;5;9;14;Cinese, Repubblica Popolare;Asia Orientale;Asia
58054;Manziana;7;7;14;Perù;America Centro-Meridionale;America
58054;Manziana;10;2;12;Bangladesh;Asia Centro-Meridionale;Asia
58054;Manziana;2;8;10;Russa, Federazione;Europa Centro-Orientale;Europa
58054;Manziana;2;6;8;Filippine;Asia Orientale;Asia
58054;Manziana;0;8;8;Georgia;Asia Occidentale;Asia
58054;Manziana;5;3;8;India;Asia Centro-Meridionale;Asia
58054;Manziana;2;4;6;Dominicana, Repubblica;America Centro-Meridionale;America
58054;Manziana;2;4;6;Germania;Unione Europea;Europa
58054;Manziana;3;3;6;Spagna;Unione Europea;Europa
58054;Manziana;3;2;5;Algeria;Africa Settentrionale;Africa
58054;Manziana;2;3;5;Bulgaria;Unione Europea;Europa
58054;Manziana;3;2;5;Colombia;America Centro-Meridionale;America
58054;Manziana;4;1;5;Stati Uniti d'America;America Settentrionale;America
58054;Manziana;1;3;4;Argentina;America Centro-Meridionale;America
58054;Manziana;2;2;4;Francia;Unione Europea;Europa
58054;Manziana;2;2;4;Norvegia;Altri paesi europei;Europa
58054;Manziana;2;2;4;Senegal;Africa Occidentale;Africa
58054;Manziana;2;2;4;Uruguay;America Centro-Meridionale;America
58054;Manziana;1;2;3;Austria;Unione Europea;Europa
58054;Manziana;0;3;3;Belgio;Unione Europea;Europa
58054;Manziana;1;2;3;Brasile;America Centro-Meridionale;America
58054;Manziana;2;1;3;Costa d'Avorio;Africa Occidentale;Africa
58054;Manziana;1;2;3;Grecia;Unione Europea;Europa
58054;Manziana;0;3;3;Paesi Bassi;Unione Europea;Europa
58054;Manziana;2;1;3;Tunisia;Africa Settentrionale;Africa
58054;Manziana;2;0;2;Benin (ex Dahomey);Africa Occidentale;Africa
58054;Manziana;1;1;2;Bielorussia;Europa Centro-Orientale;Europa
58054;Manziana;1;1;2;Bolivia;America Centro-Meridionale;America
58054;Manziana;1;1;2;Ecuador;America Centro-Meridionale;America
58054;Manziana;0;2;2;Giappone;Asia Orientale;Asia
58054;Manziana;2;0;2;Honduras;America Centro-Meridionale;America
58054;Manziana;0;2;2;Lituania;Unione Europea;Europa
58054;Manziana;0;2;2;Thailandia;Asia Orientale;Asia
58054;Manziana;0;1;1;Angola;Africa Centro-Meridionale;Africa
58054;Manziana;0;1;1;Apolide;;
58054;Manziana;0;1;1;Capo Verde;Africa Occidentale;Africa
58054;Manziana;0;1;1;Croazia;Unione Europea;Europa
58054;Manziana;1;0;1;Eritrea;Africa Orientale;Africa
58054;Manziana;0;1;1;Ghana;Africa Occidentale;Africa
58054;Manziana;0;1;1;Indonesia;Asia Orientale;Asia
58054;Manziana;0;1;1;Iran, Repubblica Islamica del;Asia Occidentale;Asia
58054;Manziana;1;0;1;Irlanda;Unione Europea;Europa
58054;Manziana;0;1;1;Kenya;Africa Orientale;Africa
58054;Manziana;0;1;1;Lettonia;Unione Europea;Europa
58054;Manziana;1;0;1;Mali;Africa Occidentale;Africa
58054;Manziana;1;0;1;Marocco;Africa Settentrionale;Africa
58054;Manziana;1;0;1;Nigeria;Africa Occidentale;Africa
58054;Manziana;0;1;1;Serbia, Repubblica di;Europa Centro-Orientale;Europa
58054;Manziana;1;0;1;Slovacchia;Unione Europea;Europa
58054;Manziana;1;0;1;Sud Africa;Africa Centro-Meridionale;Africa
58054;Manziana;0;1;1;Sudan;Africa Settentrionale;Africa
58054;Manziana;0;1;1;Venezuela;America Centro-Meridionale;America
58055;Marano Equo;24;22;46;Romania;Unione Europea;Europa
58055;Marano Equo;2;3;5;Nigeria;Africa Occidentale;Africa
58055;Marano Equo;2;2;4;Albania;Europa Centro-Orientale;Europa
58055;Marano Equo;1;3;4;Zambia;Africa Orientale;Africa
58055;Marano Equo;0;3;3;Colombia;America Centro-Meridionale;America
58055;Marano Equo;2;1;3;Spagna;Unione Europea;Europa
58055;Marano Equo;0;2;2;Congo, Repubblica democratica del (ex Zaire);Africa Centro-Meridionale;Africa
58055;Marano Equo;0;2;2;Polonia;Unione Europea;Europa
58055;Marano Equo;1;1;2;Ucraina;Europa Centro-Orientale;Europa
58055;Marano Equo;0;1;1;Ecuador;America Centro-Meridionale;America
58055;Marano Equo;0;1;1;Germania;Unione Europea;Europa
58055;Marano Equo;0;1;1;Macedonia del Nord;Europa Centro-Orientale;Europa
58055;Marano Equo;0;1;1;Slovacchia;Unione Europea;Europa
58055;Marano Equo;0;1;1;Stati Uniti d'America;America Settentrionale;America
58055;Marano Equo;0;1;1;Ungheria;Unione Europea;Europa
58056;Marcellina;449;446;895;Romania;Unione Europea;Europa
58056;Marcellina;41;39;80;Marocco;Africa Settentrionale;Africa
58056;Marcellina;18;28;46;Albania;Europa Centro-Orientale;Europa
58056;Marcellina;25;6;31;Bangladesh;Asia Centro-Meridionale;Asia
58056;Marcellina;26;0;26;Egitto;Africa Settentrionale;Africa
58056;Marcellina;24;2;26;Pakistan;Asia Centro-Meridionale;Asia
58056;Marcellina;13;11;24;Senegal;Africa Occidentale;Africa
58056;Marcellina;8;15;23;Polonia;Unione Europea;Europa
58056;Marcellina;6;10;16;Perù;America Centro-Meridionale;America
58056;Marcellina;13;3;16;Tunisia;Africa Settentrionale;Africa
58056;Marcellina;13;1;14;Gambia;Africa Occidentale;Africa
58056;Marcellina;6;8;14;Moldova;Europa Centro-Orientale;Europa
58056;Marcellina;3;11;14;Ucraina;Europa Centro-Orientale;Europa
58056;Marcellina;8;4;12;Nigeria;Africa Occidentale;Africa
58056;Marcellina;3;5;8;Colombia;America Centro-Meridionale;America
58056;Marcellina;6;0;6;Algeria;Africa Settentrionale;Africa
58056;Marcellina;1;5;6;Cinese, Repubblica Popolare;Asia Orientale;Asia
58056;Marcellina;5;0;5;Guinea;Africa Occidentale;Africa
58056;Marcellina;0;4;4;Cuba;America Centro-Meridionale;America
58056;Marcellina;3;1;4;Madagascar;Africa Orientale;Africa
58056;Marcellina;0;3;3;Bielorussia;Europa Centro-Orientale;Europa
58056;Marcellina;2;1;3;Ecuador;America Centro-Meridionale;America
58056;Marcellina;1;2;3;El Salvador;America Centro-Meridionale;America
58056;Marcellina;1;2;3;Germania;Unione Europea;Europa
58056;Marcellina;1;2;3;Macedonia del Nord;Europa Centro-Orientale;Europa
58056;Marcellina;3;0;3;Mali;Africa Occidentale;Africa
58056;Marcellina;2;1;3;Siria;Asia Occidentale;Asia
58056;Marcellina;0;2;2;Bolivia;America Centro-Meridionale;America
58056;Marcellina;0;2;2;Bosnia-Erzegovina;Europa Centro-Orientale;Europa
58056;Marcellina;1;1;2;Camerun;Africa Centro-Meridionale;Africa
58056;Marcellina;2;0;2;Capo Verde;Africa Occidentale;Africa
58056;Marcellina;1;1;2;Costa d'Avorio;Africa Occidentale;Africa
58056;Marcellina;1;1;2;Filippine;Asia Orientale;Asia
58056;Marcellina;0;2;2;Francia;Unione Europea;Europa
58056;Marcellina;1;1;2;Grecia;Unione Europea;Europa
58056;Marcellina;1;1;2;Guatemala;America Centro-Meridionale;America
58056;Marcellina;2;0;2;Guinea Bissau;Africa Occidentale;Africa
58056;Marcellina;2;0;2;Sri Lanka (ex Ceylon);Asia Centro-Meridionale;Asia
58056;Marcellina;2;0;2;Togo;Africa Occidentale;Africa
58056;Marcellina;1;0;1;Afghanistan;Asia Centro-Meridionale;Asia
58056;Marcellina;0;1;1;Brasile;America Centro-Meridionale;America
58056;Marcellina;1;0;1;Congo, Repubblica democratica del (ex Zaire);Africa Centro-Meridionale;Africa
58056;Marcellina;0;1;1;Dominicana, Repubblica;America Centro-Meridionale;America
58056;Marcellina;0;1;1;Eritrea;Africa Orientale;Africa
58056;Marcellina;0;1;1;Giappone;Asia Orientale;Asia
58056;Marcellina;0;1;1;Honduras;America Centro-Meridionale;America
58056;Marcellina;1;0;1;India;Asia Centro-Meridionale;Asia
58056;Marcellina;1;0;1;Iraq;Asia Occidentale;Asia
58056;Marcellina;0;1;1;Messico;America Centro-Meridionale;America
58056;Marcellina;0;1;1;Regno Unito;Altri paesi europei;Europa
58056;Marcellina;0;1;1;Serbia, Repubblica di;Europa Centro-Orientale;Europa
58056;Marcellina;1;0;1;Sierra Leone;Africa Occidentale;Africa
58056;Marcellina;0;1;1;Spagna;Unione Europea;Europa
58056;Marcellina;1;0;1;Sudan;Africa Settentrionale;Africa
58056;Marcellina;1;0;1;Turchia;Europa Centro-Orientale;Europa
58057;Marino;822;993;1815;Romania;Unione Europea;Europa
58057;Marino;265;245;510;Albania;Europa Centro-Orientale;Europa
58057;Marino;58;137;195;Ucraina;Europa Centro-Orientale;Europa
58057;Marino;138;25;163;India;Asia Centro-Meridionale;Asia
58057;Marino;121;40;161;Bangladesh;Asia Centro-Meridionale;Asia
58057;Marino;122;36;158;Egitto;Africa Settentrionale;Africa
58057;Marino;34;65;99;Moldova;Europa Centro-Orientale;Europa
58057;Marino;47;48;95;Cinese, Repubblica Popolare;Asia Orientale;Asia
58057;Marino;25;69;94;Polonia;Unione Europea;Europa
58057;Marino;41;33;74;Marocco;Africa Settentrionale;Africa
58057;Marino;13;57;70;Nigeria;Africa Occidentale;Africa
58057;Marino;32;21;53;Tunisia;Africa Settentrionale;Africa
58057;Marino;46;5;51;Pakistan;Asia Centro-Meridionale;Asia
58057;Marino;15;30;45;Colombia;America Centro-Meridionale;America
58057;Marino;6;38;44;Cuba;America Centro-Meridionale;America
58057;Marino;11;33;44;Filippine;Asia Orientale;Asia
58057;Marino;9;33;42;Bulgaria;Unione Europea;Europa
58057;Marino;12;27;39;Perù;America Centro-Meridionale;America
58057;Marino;13;21;34;Regno Unito;Altri paesi europei;Europa
58057;Marino;19;12;31;Sri Lanka (ex Ceylon);Asia Centro-Meridionale;Asia
58057;Marino;8;21;29;Spagna;Unione Europea;Europa
58057;Marino;5;22;27;Brasile;America Centro-Meridionale;America
58057;Marino;9;15;24;Dominicana, Repubblica;America Centro-Meridionale;America
58057;Marino;9;15;24;Germania;Unione Europea;Europa
58057;Marino;1;23;24;Russa, Federazione;Europa Centro-Orientale;Europa
58057;Marino;8;14;22;Francia;Unione Europea;Europa
58057;Marino;16;3;19;Turchia;Europa Centro-Orientale;Europa
58057;Marino;6;11;17;Ecuador;America Centro-Meridionale;America
58057;Marino;8;8;16;Stati Uniti d'America;America Settentrionale;America
58057;Marino;6;9;15;Portogallo;Unione Europea;Europa
58057;Marino;5;10;15;Ungheria;Unione Europea;Europa
58057;Marino;6;8;14;Venezuela;America Centro-Meridionale;America
58057;Marino;0;12;12;Indonesia;Asia Orientale;Asia
58057;Marino;4;7;11;Iran, Repubblica Islamica del;Asia Occidentale;Asia
58057;Marino;4;7;11;Paesi Bassi;Unione Europea;Europa
58057;Marino;3;7;10;Malta;Unione Europea;Europa
58057;Marino;3;6;9;Argentina;America Centro-Meridionale;America
58057;Marino;3;6;9;Grecia;Unione Europea;Europa
58057;Marino;2;6;8;Capo Verde;Africa Occidentale;Africa
58057;Marino;4;4;8;Somalia;Africa Orientale;Africa
58057;Marino;2;5;7;Bosnia-Erzegovina;Europa Centro-Orientale;Europa
58057;Marino;2;5;7;Georgia;Asia Occidentale;Asia
58057;Marino;4;3;7;Guinea;Africa Occidentale;Africa
58057;Marino;2;4;6;Camerun;Africa Centro-Meridionale;Africa
58057;Marino;1;5;6;Ceca, Repubblica;Unione Europea;Europa
58057;Marino;2;4;6;Croazia;Unione Europea;Europa
58057;Marino;0;6;6;El Salvador;America Centro-Meridionale;America
58057;Marino;1;5;6;Etiopia;Africa Orientale;Africa
58057;Marino;2;4;6;Ghana;Africa Occidentale;Africa
58057;Marino;1;5;6;Kenya;Africa Orientale;Africa
58057;Marino;3;3;6;Macedonia del Nord;Europa Centro-Orientale;Europa
58057;Marino;1;5;6;Serbia, Repubblica di;Europa Centro-Orientale;Europa
58057;Marino;3;2;5;Giappone;Asia Orientale;Asia
58057;Marino;5;0;5;Iraq;Asia Occidentale;Asia
58057;Marino;5;0;5;Senegal;Africa Occidentale;Africa
58057;Marino;0;5;5;Slovacchia;Unione Europea;Europa
58057;Marino;2;3;5;Svezia;Unione Europea;Europa
58057;Marino;1;3;4;Benin (ex Dahomey);Africa Occidentale;Africa
58057;Marino;1;3;4;Bielorussia;Europa Centro-Orientale;Europa
58057;Marino;2;2;4;Territori dell'Autonomia Palestinese;Asia Occidentale;Asia
58057;Marino;1;2;3;Austria;Unione Europea;Europa
58057;Marino;2;1;3;Costa d'Avorio;Africa Occidentale;Africa
58057;Marino;1;2;3;Eritrea;Africa Orientale;Africa
58057;Marino;0;3;3;Finlandia;Unione Europea;Europa
58057;Marino;1;2;3;Honduras;America Centro-Meridionale;America
58057;Marino;0;3;3;Madagascar;Africa Orientale;Africa
58057;Marino;2;1;3;Siria;Asia Occidentale;Asia
58057;Marino;0;3;3;Thailandia;Asia Orientale;Asia
58057;Marino;2;0;2;Afghanistan;Asia Centro-Meridionale;Asia
58057;Marino;1;1;2;Algeria;Africa Settentrionale;Africa
58057;Marino;1;1;2;Belgio;Unione Europea;Europa
58057;Marino;1;1;2;Cile;America Centro-Meridionale;America
58057;Marino;0;2;2;Danimarca;Unione Europea;Europa
58057;Marino;1;1;2;Dominica;America Centro-Meridionale;America
58057;Marino;0;2;2;Estonia;Unione Europea;Europa
58057;Marino;0;2;2;Gambia;Africa Occidentale;Africa
58057;Marino;0;2;2;Israele;Asia Occidentale;Asia
58057;Marino;1;1;2;Lituania;Unione Europea;Europa
58057;Marino;0;2;2;Mauritius;Africa Orientale;Africa
58057;Marino;2;0;2;San Marino;Altri paesi europei;Europa
58057;Marino;1;0;1;Apolide;;
58057;Marino;0;1;1;Azerbaigian;Asia Occidentale;Asia
58057;Marino;1;0;1;Bolivia;America Centro-Meridionale;America
58057;Marino;0;1;1;Canada;America Settentrionale;America
58057;Marino;0;1;1;Congo, Repubblica democratica del (ex Zaire);Africa Centro-Meridionale;Africa
58057;Marino;0;1;1;Corea, Repubblica (Corea del Sud);Asia Orientale;Asia
58057;Marino;0;1;1;Giordania;Asia Occidentale;Asia
58057;Marino;1;0;1;Guatemala;America Centro-Meridionale;America
58057;Marino;0;1;1;Haiti;America Centro-Meridionale;America
58057;Marino;0;1;1;Irlanda;Unione Europea;Europa
58057;Marino;0;1;1;Kirghizistan;Asia Centro-Meridionale;Asia
58057;Marino;0;1;1;Libia;Africa Settentrionale;Africa
58057;Marino;0;1;1;Malaysia;Asia Orientale;Asia
58057;Marino;1;0;1;Mali;Africa Occidentale;Africa
58057;Marino;0;1;1;Messico;America Centro-Meridionale;America
58057;Marino;0;1;1;Mozambico;Africa Orientale;Africa
58057;Marino;1;0;1;Nuova Zelanda;Oceania;Oceania
58057;Marino;0;1;1;Panama;America Centro-Meridionale;America
58057;Marino;1;0;1;Sierra Leone;Africa Occidentale;Africa
58057;Marino;1;0;1;Zambia;Africa Orientale;Africa
58058;Mazzano Romano;96;114;210;Romania;Unione Europea;Europa
58058;Mazzano Romano;8;14;22;Polonia;Unione Europea;Europa
58058;Mazzano Romano;6;10;16;Moldova;Europa Centro-Orientale;Europa
58058;Mazzano Romano;11;3;14;Marocco;Africa Settentrionale;Africa
58058;Mazzano Romano;6;5;11;Ucraina;Europa Centro-Orientale;Europa
58058;Mazzano Romano;5;3;8;Albania;Europa Centro-Orientale;Europa
58058;Mazzano Romano;4;3;7;Sri Lanka (ex Ceylon);Asia Centro-Meridionale;Asia
58058;Mazzano Romano;5;1;6;India;Asia Centro-Meridionale;Asia
58058;Mazzano Romano;3;2;5;Regno Unito;Altri paesi europei;Europa
58058;Mazzano Romano;2;2;4;Germania;Unione Europea;Europa
58058;Mazzano Romano;2;1;3;Bangladesh;Asia Centro-Meridionale;Asia
58058;Mazzano Romano;2;1;3;Bielorussia;Europa Centro-Orientale;Europa
58058;Mazzano Romano;1;2;3;Brasile;America Centro-Meridionale;America
58058;Mazzano Romano;0;3;3;Filippine;Asia Orientale;Asia
58058;Mazzano Romano;1;2;3;Finlandia;Unione Europea;Europa
58058;Mazzano Romano;0;3;3;Tunisia;Africa Settentrionale;Africa
58058;Mazzano Romano;1;1;2;Belgio;Unione Europea;Europa
58058;Mazzano Romano;0;2;2;Perù;America Centro-Meridionale;America
58058;Mazzano Romano;1;0;1;Argentina;America Centro-Meridionale;America
58058;Mazzano Romano;0;1;1;Austria;Unione Europea;Europa
58058;Mazzano Romano;1;0;1;Bosnia-Erzegovina;Europa Centro-Orientale;Europa
58058;Mazzano Romano;0;1;1;Bulgaria;Unione Europea;Europa
58058;Mazzano Romano;0;1;1;Camerun;Africa Centro-Meridionale;Africa
58058;Mazzano Romano;0;1;1;Ceca, Repubblica;Unione Europea;Europa
58058;Mazzano Romano;1;0;1;Ecuador;America Centro-Meridionale;America
58058;Mazzano Romano;1;0;1;Egitto;Africa Settentrionale;Africa
58058;Mazzano Romano;0;1;1;Eritrea;Africa Orientale;Africa
58058;Mazzano Romano;0;1;1;Etiopia;Africa Orientale;Africa
58058;Mazzano Romano;0;1;1;Francia;Unione Europea;Europa
58058;Mazzano Romano;0;1;1;Giappone;Asia Orientale;Asia
58058;Mazzano Romano;0;1;1;Iran, Repubblica Islamica del;Asia Occidentale;Asia
58058;Mazzano Romano;1;0;1;Macedonia del Nord;Europa Centro-Orientale;Europa
58058;Mazzano Romano;0;1;1;Malaysia;Asia Orientale;Asia
58058;Mazzano Romano;1;0;1;Russa, Federazione;Europa Centro-Orientale;Europa
58058;Mazzano Romano;0;1;1;Venezuela;America Centro-Meridionale;America
58059;Mentana;751;762;1513;Romania;Unione Europea;Europa
58059;Mentana;354;277;631;Albania;Europa Centro-Orientale;Europa
58059;Mentana;79;62;141;Macedonia del Nord;Europa Centro-Orientale;Europa
58059;Mentana;38;53;91;Moldova;Europa Centro-Orientale;Europa
58059;Mentana;72;14;86;Bangladesh;Asia Centro-Meridionale;Asia
58059;Mentana;28;58;86;Polonia;Unione Europea;Europa
58059;Mentana;28;43;71;Filippine;Asia Orientale;Asia
58059;Mentana;18;46;64;Ucraina;Europa Centro-Orientale;Europa
58059;Mentana;28;33;61;Cinese, Repubblica Popolare;Asia Orientale;Asia
58059;Mentana;19;24;43;Congo (Repubblica del);Africa Centro-Meridionale;Africa
58059;Mentana;34;8;42;Egitto;Africa Settentrionale;Africa
58059;Mentana;24;18;42;Perù;America Centro-Meridionale;America
58059;Mentana;22;10;32;Tunisia;Africa Settentrionale;Africa
58059;Mentana;16;12;28;Ecuador;America Centro-Meridionale;America
58059;Mentana;11;16;27;Camerun;Africa Centro-Meridionale;Africa
58059;Mentana;15;8;23;Kosovo;Europa Centro-Orientale;Europa
58059;Mentana;12;7;19;Sri Lanka (ex Ceylon);Asia Centro-Meridionale;Asia
58059;Mentana;8;10;18;Bulgaria;Unione Europea;Europa
58059;Mentana;6;8;14;Capo Verde;Africa Occidentale;Africa
58059;Mentana;4;8;12;Niger;Africa Occidentale;Africa
58059;Mentana;5;6;11;Marocco;Africa Settentrionale;Africa
58059;Mentana;6;5;11;Nigeria;Africa Occidentale;Africa
58059;Mentana;10;1;11;Pakistan;Asia Centro-Meridionale;Asia
58059;Mentana;3;7;10;Brasile;America Centro-Meridionale;America
58059;Mentana;3;7;10;Francia;Unione Europea;Europa
58059;Mentana;9;1;10;Senegal;Africa Occidentale;Africa
58059;Mentana;2;7;9;Spagna;Unione Europea;Europa
58059;Mentana;7;1;8;Iraq;Asia Occidentale;Asia
58059;Mentana;2;6;8;Portogallo;Unione Europea;Europa
58059;Mentana;3;4;7;Congo, Repubblica democratica del (ex Zaire);Africa Centro-Meridionale;Africa
58059;Mentana;3;4;7;Somalia;Africa Orientale;Africa
58059;Mentana;1;5;6;Colombia;America Centro-Meridionale;America
58059;Mentana;3;3;6;Costa d'Avorio;Africa Occidentale;Africa
58059;Mentana;6;0;6;India;Asia Centro-Meridionale;Asia
58059;Mentana;5;0;5;Afghanistan;Asia Centro-Meridionale;Asia
58059;Mentana;3;2;5;Bolivia;America Centro-Meridionale;America
58059;Mentana;2;3;5;Cuba;America Centro-Meridionale;America
58059;Mentana;2;3;5;El Salvador;America Centro-Meridionale;America
58059;Mentana;4;1;5;Guinea;Africa Occidentale;Africa
58059;Mentana;3;2;5;Madagascar;Africa Orientale;Africa
58059;Mentana;0;5;5;Russa, Federazione;Europa Centro-Orientale;Europa
58059;Mentana;2;2;4;Dominicana, Repubblica;America Centro-Meridionale;America
58059;Mentana;4;0;4;Grecia;Unione Europea;Europa
58059;Mentana;2;2;4;Iran, Repubblica Islamica del;Asia Occidentale;Asia
58059;Mentana;3;0;3;Eritrea;Africa Orientale;Africa
58059;Mentana;1;2;3;Siria;Asia Occidentale;Asia
58059;Mentana;1;2;3;Svezia;Unione Europea;Europa
58059;Mentana;0;2;2;Belgio;Unione Europea;Europa
58059;Mentana;2;0;2;Benin (ex Dahomey);Africa Occidentale;Africa
58059;Mentana;1;1;2;Cile;America Centro-Meridionale;America
58059;Mentana;1;1;2;Corea, Repubblica (Corea del Sud);Asia Orientale;Asia
58059;Mentana;0;2;2;Finlandia;Unione Europea;Europa
58059;Mentana;1;1;2;Regno Unito;Altri paesi europei;Europa
58059;Mentana;0;2;2;Slovacchia;Unione Europea;Europa
58059;Mentana;2;0;2;Stati Uniti d'America;America Settentrionale;America
58059;Mentana;0;1;1;Angola;Africa Centro-Meridionale;Africa
58059;Mentana;1;0;1;Apolide;;
58059;Mentana;0;1;1;Argentina;America Centro-Meridionale;America
58059;Mentana;0;1;1;Bielorussia;Europa Centro-Orientale;Europa
58059;Mentana;1;0;1;Bosnia-Erzegovina;Europa Centro-Orientale;Europa
58059;Mentana;0;1;1;Ceca, Repubblica;Unione Europea;Europa
58059;Mentana;0;1;1;Croazia;Unione Europea;Europa
58059;Mentana;0;1;1;Dominica;America Centro-Meridionale;America
58059;Mentana;0;1;1;Etiopia;Africa Orientale;Africa
58059;Mentana;1;0;1;Gambia;Africa Occidentale;Africa
58059;Mentana;0;1;1;Germania;Unione Europea;Europa
58059;Mentana;1;0;1;Ghana;Africa Occidentale;Africa
58059;Mentana;0;1;1;Guatemala;America Centro-Meridionale;America
58059;Mentana;0;1;1;Honduras;America Centro-Meridionale;America
58059;Mentana;1;0;1;Irlanda;Unione Europea;Europa
58059;Mentana;0;1;1;Kuwait;Asia Occidentale;Asia
58059;Mentana;0;1;1;Libano;Asia Occidentale;Asia
58059;Mentana;0;1;1;Lituania;Unione Europea;Europa
58059;Mentana;0;1;1;Lussemburgo;Unione Europea;Europa
58059;Mentana;1;0;1;Mauritania;Africa Occidentale;Africa
58059;Mentana;0;1;1;Mauritius;Africa Orientale;Africa
58059;Mentana;0;1;1;Mozambico;Africa Orientale;Africa
58059;Mentana;1;0;1;Nicaragua;America Centro-Meridionale;America
58059;Mentana;0;1;1;Paraguay;America Centro-Meridionale;America
58059;Mentana;1;0;1;Serbia, Repubblica di;Europa Centro-Orientale;Europa
58059;Mentana;0;1;1;Sierra Leone;Africa Occidentale;Africa
58059;Mentana;0;1;1;Svizzera;Altri paesi europei;Europa
58059;Mentana;1;0;1;Togo;Africa Occidentale;Africa
58059;Mentana;1;0;1;Turchia;Europa Centro-Orientale;Europa
58059;Mentana;0;1;1;Ungheria;Unione Europea;Europa
58059;Mentana;0;1;1;Vietnam;Asia Orientale;Asia
58060;Monte Compatri;408;459;867;Romania;Unione Europea;Europa
58060;Monte Compatri;81;68;149;Albania;Europa Centro-Orientale;Europa
58060;Monte Compatri;42;37;79;Nigeria;Africa Occidentale;Africa
58060;Monte Compatri;30;40;70;Moldova;Europa Centro-Orientale;Europa
58060;Monte Compatri;12;40;52;Ucraina;Europa Centro-Orientale;Europa
58060;Monte Compatri;9;12;21;Polonia;Unione Europea;Europa
58060;Monte Compatri;18;1;19;Pakistan;Asia Centro-Meridionale;Asia
58060;Monte Compatri;13;5;18;Bangladesh;Asia Centro-Meridionale;Asia
58060;Monte Compatri;6;11;17;Filippine;Asia Orientale;Asia
58060;Monte Compatri;12;5;17;Marocco;Africa Settentrionale;Africa
58060;Monte Compatri;5;11;16;Perù;America Centro-Meridionale;America
58060;Monte Compatri;6;7;13;Cinese, Repubblica Popolare;Asia Orientale;Asia
58060;Monte Compatri;5;5;10;Francia;Unione Europea;Europa
58060;Monte Compatri;5;5;10;Germania;Unione Europea;Europa
58060;Monte Compatri;5;5;10;Kosovo;Europa Centro-Orientale;Europa
58060;Monte Compatri;2;8;10;Russa, Federazione;Europa Centro-Orientale;Europa
58060;Monte Compatri;7;2;9;India;Asia Centro-Meridionale;Asia
58060;Monte Compatri;6;3;9;Regno Unito;Altri paesi europei;Europa
58060;Monte Compatri;0;6;6;Bielorussia;Europa Centro-Orientale;Europa
58060;Monte Compatri;2;4;6;Cuba;America Centro-Meridionale;America
58060;Monte Compatri;3;3;6;Egitto;Africa Settentrionale;Africa
58060;Monte Compatri;2;4;6;Venezuela;America Centro-Meridionale;America
58060;Monte Compatri;2;3;5;Algeria;Africa Settentrionale;Africa
58060;Monte Compatri;3;2;5;Macedonia del Nord;Europa Centro-Orientale;Europa
58060;Monte Compatri;3;2;5;Sri Lanka (ex Ceylon);Asia Centro-Meridionale;Asia
58060;Monte Compatri;3;2;5;Tunisia;Africa Settentrionale;Africa
58060;Monte Compatri;0;4;4;Brasile;America Centro-Meridionale;America
58060;Monte Compatri;4;0;4;Costa d'Avorio;Africa Occidentale;Africa
58060;Monte Compatri;2;2;4;Dominicana, Repubblica;America Centro-Meridionale;America
58060;Monte Compatri;4;0;4;Senegal;Africa Occidentale;Africa
58060;Monte Compatri;1;3;4;Serbia, Repubblica di;Europa Centro-Orientale;Europa
58060;Monte Compatri;1;3;4;Spagna;Unione Europea;Europa
58060;Monte Compatri;0;3;3;Argentina;America Centro-Meridionale;America
58060;Monte Compatri;3;0;3;Austria;Unione Europea;Europa
58060;Monte Compatri;0;3;3;Bulgaria;Unione Europea;Europa
58060;Monte Compatri;2;1;3;Burkina Faso (ex Alto Volta);Africa Occidentale;Africa
58060;Monte Compatri;2;1;3;Ecuador;America Centro-Meridionale;America
58060;Monte Compatri;2;1;3;Gambia;Africa Occidentale;Africa
58060;Monte Compatri;0;3;3;Georgia;Asia Occidentale;Asia
58060;Monte Compatri;0;3;3;Guatemala;America Centro-Meridionale;America
58060;Monte Compatri;0;3;3;Messico;America Centro-Meridionale;America
58060;Monte Compatri;1;2;3;Ungheria;Unione Europea;Europa
58060;Monte Compatri;2;0;2;Bosnia-Erzegovina;Europa Centro-Orientale;Europa
58060;Monte Compatri;1;1;2;Colombia;America Centro-Meridionale;America
58060;Monte Compatri;1;1;2;Portogallo;Unione Europea;Europa
58060;Monte Compatri;0;2;2;Stati Uniti d'America;America Settentrionale;America
58060;Monte Compatri;0;2;2;Svezia;Unione Europea;Europa
58060;Monte Compatri;1;0;1;Afghanistan;Asia Centro-Meridionale;Asia
58060;Monte Compatri;0;1;1;Belgio;Unione Europea;Europa
58060;Monte Compatri;1;0;1;Camerun;Africa Centro-Meridionale;Africa
58060;Monte Compatri;0;1;1;Ceca, Repubblica;Unione Europea;Europa
58060;Monte Compatri;0;1;1;Cile;America Centro-Meridionale;America
58060;Monte Compatri;0;1;1;Etiopia;Africa Orientale;Africa
58060;Monte Compatri;0;1;1;Giappone;Asia Orientale;Asia
58060;Monte Compatri;1;0;1;Grecia;Unione Europea;Europa
58060;Monte Compatri;0;1;1;Kenya;Africa Orientale;Africa
58060;Monte Compatri;0;1;1;Libano;Asia Occidentale;Asia
58060;Monte Compatri;1;0;1;Niger;Africa Occidentale;Africa
58060;Monte Compatri;0;1;1;Norvegia;Altri paesi europei;Europa
58060;Monte Compatri;1;0;1;Paesi Bassi;Unione Europea;Europa
58060;Monte Compatri;1;0;1;Sierra Leone;Africa Occidentale;Africa
58060;Monte Compatri;0;1;1;Singapore;Asia Orientale;Asia
58060;Monte Compatri;0;1;1;Slovacchia;Unione Europea;Europa
58060;Monte Compatri;0;1;1;Thailandia;Asia Orientale;Asia
58061;Monteflavio;25;21;46;Macedonia del Nord;Europa Centro-Orientale;Europa
58061;Monteflavio;17;25;42;Romania;Unione Europea;Europa
58061;Monteflavio;3;4;7;Albania;Europa Centro-Orientale;Europa
58061;Monteflavio;3;2;5;Polonia;Unione Europea;Europa
58061;Monteflavio;1;2;3;Marocco;Africa Settentrionale;Africa
58061;Monteflavio;1;1;2;Serbia, Repubblica di;Europa Centro-Orientale;Europa
58061;Monteflavio;1;0;1;Iran, Repubblica Islamica del;Asia Occidentale;Asia
58062;Montelanico;36;46;82;Romania;Unione Europea;Europa
58062;Montelanico;27;38;65;Bulgaria;Unione Europea;Europa
58062;Montelanico;8;2;10;Nigeria;Africa Occidentale;Africa
58062;Montelanico;9;0;9;Iraq;Asia Occidentale;Asia
58062;Montelanico;2;3;5;Marocco;Africa Settentrionale;Africa
58062;Montelanico;1;1;2;Congo, Repubblica democratica del (ex Zaire);Africa Centro-Meridionale;Africa
58062;Montelanico;0;2;2;Perù;America Centro-Meridionale;America
58062;Montelanico;1;0;1;Bangladesh;Asia Centro-Meridionale;Asia
58062;Montelanico;1;0;1;Burkina Faso (ex Alto Volta);Africa Occidentale;Africa
58062;Montelanico;0;1;1;Cuba;America Centro-Meridionale;America
58062;Montelanico;0;1;1;Giappone;Asia Orientale;Asia
58062;Montelanico;1;0;1;India;Asia Centro-Meridionale;Asia
58062;Montelanico;1;0;1;Iran, Repubblica Islamica del;Asia Occidentale;Asia
58062;Montelanico;0;1;1;Moldova;Europa Centro-Orientale;Europa
58062;Montelanico;1;0;1;Pakistan;Asia Centro-Meridionale;Asia
58062;Montelanico;0;1;1;Polonia;Unione Europea;Europa
58062;Montelanico;0;1;1;Regno Unito;Altri paesi europei;Europa
58062;Montelanico;1;0;1;Senegal;Africa Occidentale;Africa
58062;Montelanico;1;0;1;Siria;Asia Occidentale;Asia
58062;Montelanico;1;0;1;Territori dell'Autonomia Palestinese;Asia Occidentale;Asia
58062;Montelanico;0;1;1;Ucraina;Europa Centro-Orientale;Europa
58062;Montelanico;1;0;1;Venezuela;America Centro-Meridionale;America
58063;Montelibretti;128;125;253;Romania;Unione Europea;Europa
58063;Montelibretti;18;13;31;Macedonia del Nord;Europa Centro-Orientale;Europa
58063;Montelibretti;5;11;16;Perù;America Centro-Meridionale;America
58063;Montelibretti;3;12;15;Polonia;Unione Europea;Europa
58063;Montelibretti;10;4;14;Albania;Europa Centro-Orientale;Europa
58063;Montelibretti;7;7;14;Filippine;Asia Orientale;Asia
58063;Montelibretti;6;7;13;Marocco;Africa Settentrionale;Africa
58063;Montelibretti;7;6;13;Moldova;Europa Centro-Orientale;Europa
58063;Montelibretti;2;8;10;Ucraina;Europa Centro-Orientale;Europa
58063;Montelibretti;4;5;9;India;Asia Centro-Meridionale;Asia
58063;Montelibretti;4;3;7;Egitto;Africa Settentrionale;Africa
58063;Montelibretti;3;3;6;Colombia;America Centro-Meridionale;America
58063;Montelibretti;2;4;6;Kosovo;Europa Centro-Orientale;Europa
58063;Montelibretti;1;5;6;Regno Unito;Altri paesi europei;Europa
58063;Montelibretti;2;2;4;Bangladesh;Asia Centro-Meridionale;Asia
58063;Montelibretti;1;3;4;Russa, Federazione;Europa Centro-Orientale;Europa
58063;Montelibretti;3;1;4;Sri Lanka (ex Ceylon);Asia Centro-Meridionale;Asia
58063;Montelibretti;1;2;3;Brasile;America Centro-Meridionale;America
58063;Montelibretti;1;2;3;Cile;America Centro-Meridionale;America
58063;Montelibretti;0;3;3;Germania;Unione Europea;Europa
58063;Montelibretti;1;2;3;Nigeria;Africa Occidentale;Africa
58063;Montelibretti;1;1;2;Argentina;America Centro-Meridionale;America
58063;Montelibretti;0;2;2;Francia;Unione Europea;Europa
58063;Montelibretti;0;2;2;Mauritius;Africa Orientale;Africa
58063;Montelibretti;0;2;2;Somalia;Africa Orientale;Africa
58063;Montelibretti;0;2;2;Venezuela;America Centro-Meridionale;America
58063;Montelibretti;1;0;1;Afghanistan;Asia Centro-Meridionale;Asia
58063;Montelibretti;0;1;1;Armenia;Asia Occidentale;Asia
58063;Montelibretti;1;0;1;Burkina Faso (ex Alto Volta);Africa Occidentale;Africa
58063;Montelibretti;0;1;1;Cinese, Repubblica Popolare;Asia Orientale;Asia
58063;Montelibretti;0;1;1;Cuba;America Centro-Meridionale;America
58063;Montelibretti;0;1;1;Dominicana, Repubblica;America Centro-Meridionale;America
58063;Montelibretti;1;0;1;Ecuador;America Centro-Meridionale;America
58063;Montelibretti;1;0;1;Gambia;Africa Occidentale;Africa
58063;Montelibretti;1;0;1;Guinea;Africa Occidentale;Africa
58063;Montelibretti;1;0;1;Guinea Bissau;Africa Occidentale;Africa
58063;Montelibretti;1;0;1;Namibia;Africa Centro-Meridionale;Africa
58063;Montelibretti;1;0;1;Pakistan;Asia Centro-Meridionale;Asia
58063;Montelibretti;1;0;1;Senegal;Africa Occidentale;Africa
58063;Montelibretti;0;1;1;Slovacchia;Unione Europea;Europa
58063;Montelibretti;0;1;1;Spagna;Unione Europea;Europa
58063;Montelibretti;1;0;1;Tunisia;Africa Settentrionale;Africa
58063;Montelibretti;1;0;1;Ungheria;Unione Europea;Europa
58064;Monte Porzio Catone;45;75;120;Romania;Unione Europea;Europa
58064;Monte Porzio Catone;26;27;53;Albania;Europa Centro-Orientale;Europa
58064;Monte Porzio Catone;11;15;26;Francia;Unione Europea;Europa
58064;Monte Porzio Catone;6;13;19;Ucraina;Europa Centro-Orientale;Europa
58064;Monte Porzio Catone;9;8;17;Filippine;Asia Orientale;Asia
58064;Monte Porzio Catone;5;12;17;Regno Unito;Altri paesi europei;Europa
58064;Monte Porzio Catone;8;8;16;Polonia;Unione Europea;Europa
58064;Monte Porzio Catone;4;6;10;Moldova;Europa Centro-Orientale;Europa
58064;Monte Porzio Catone;3;6;9;India;Asia Centro-Meridionale;Asia
58064;Monte Porzio Catone;4;4;8;Germania;Unione Europea;Europa
58064;Monte Porzio Catone;2;4;6;Spagna;Unione Europea;Europa
58064;Monte Porzio Catone;5;1;6;Stati Uniti d'America;America Settentrionale;America
58064;Monte Porzio Catone;2;3;5;Giordania;Asia Occidentale;Asia
58064;Monte Porzio Catone;3;2;5;Iran, Repubblica Islamica del;Asia Occidentale;Asia
58064;Monte Porzio Catone;2;3;5;Marocco;Africa Settentrionale;Africa
58064;Monte Porzio Catone;1;3;4;Bangladesh;Asia Centro-Meridionale;Asia
58064;Monte Porzio Catone;3;1;4;Cinese, Repubblica Popolare;Asia Orientale;Asia
58064;Monte Porzio Catone;4;0;4;Colombia;America Centro-Meridionale;America
58064;Monte Porzio Catone;1;3;4;Georgia;Asia Occidentale;Asia
58064;Monte Porzio Catone;1;3;4;Grecia;Unione Europea;Europa
58064;Monte Porzio Catone;3;1;4;Sri Lanka (ex Ceylon);Asia Centro-Meridionale;Asia
58064;Monte Porzio Catone;2;1;3;Belgio;Unione Europea;Europa
58064;Monte Porzio Catone;3;0;3;Egitto;Africa Settentrionale;Africa
58064;Monte Porzio Catone;2;1;3;Paesi Bassi;Unione Europea;Europa
58064;Monte Porzio Catone;0;3;3;Russa, Federazione;Europa Centro-Orientale;Europa
58064;Monte Porzio Catone;0;3;3;Svizzera;Altri paesi europei;Europa
58064;Monte Porzio Catone;0;2;2;Brasile;America Centro-Meridionale;America
58064;Monte Porzio Catone;0;2;2;Bulgaria;Unione Europea;Europa
58064;Monte Porzio Catone;0;2;2;Cuba;America Centro-Meridionale;America
58064;Monte Porzio Catone;1;1;2;El Salvador;America Centro-Meridionale;America
58064;Monte Porzio Catone;0;2;2;Giappone;Asia Orientale;Asia
58064;Monte Porzio Catone;2;0;2;Serbia, Repubblica di;Europa Centro-Orientale;Europa
58064;Monte Porzio Catone;1;1;2;Siria;Asia Occidentale;Asia
58064;Monte Porzio Catone;0;1;1;Argentina;America Centro-Meridionale;America
58064;Monte Porzio Catone;0;1;1;Austria;Unione Europea;Europa
58064;Monte Porzio Catone;1;0;1;Benin (ex Dahomey);Africa Occidentale;Africa
58064;Monte Porzio Catone;0;1;1;Camerun;Africa Centro-Meridionale;Africa
58064;Monte Porzio Catone;1;0;1;Corea, Repubblica (Corea del Sud);Asia Orientale;Asia
58064;Monte Porzio Catone;1;0;1;Costa d'Avorio;Africa Occidentale;Africa
58064;Monte Porzio Catone;0;1;1;Croazia;Unione Europea;Europa
58064;Monte Porzio Catone;0;1;1;Danimarca;Unione Europea;Europa
58064;Monte Porzio Catone;0;1;1;Etiopia;Africa Orientale;Africa
58064;Monte Porzio Catone;1;0;1;Guinea Bissau;Africa Occidentale;Africa
58064;Monte Porzio Catone;1;0;1;Guyana;America Centro-Meridionale;America
58064;Monte Porzio Catone;0;1;1;Lettonia;Unione Europea;Europa
58064;Monte Porzio Catone;1;0;1;Montenegro;Europa Centro-Orientale;Europa
58064;Monte Porzio Catone;1;0;1;Pakistan;Asia Centro-Meridionale;Asia
58064;Monte Porzio Catone;0;1;1;Paraguay;America Centro-Meridionale;America
58064;Monte Porzio Catone;1;0;1;Perù;America Centro-Meridionale;America
58064;Monte Porzio Catone;0;1;1;Slovacchia;Unione Europea;Europa
58064;Monte Porzio Catone;0;1;1;Svezia;Unione Europea;Europa
58064;Monte Porzio Catone;0;1;1;Thailandia;Asia Orientale;Asia
58064;Monte Porzio Catone;1;0;1;Turchia;Europa Centro-Orientale;Europa
58064;Monte Porzio Catone;0;1;1;Venezuela;America Centro-Meridionale;America
58065;Monterotondo;1218;1332;2550;Romania;Unione Europea;Europa
58065;Monterotondo;166;162;328;Albania;Europa Centro-Orientale;Europa
58065;Monterotondo;129;180;309;Moldova;Europa Centro-Orientale;Europa
58065;Monterotondo;85;138;223;Polonia;Unione Europea;Europa
58065;Monterotondo;114;50;164;Bangladesh;Asia Centro-Meridionale;Asia
58065;Monterotondo;50;113;163;Ucraina;Europa Centro-Orientale;Europa
58065;Monterotondo;55;53;108;Cinese, Repubblica Popolare;Asia Orientale;Asia
58065;Monterotondo;35;61;96;Perù;America Centro-Meridionale;America
58065;Monterotondo;68;11;79;Egitto;Africa Settentrionale;Africa
58065;Monterotondo;41;24;65;Pakistan;Asia Centro-Meridionale;Asia
58065;Monterotondo;19;39;58;Nigeria;Africa Occidentale;Africa
58065;Monterotondo;23;34;57;Ecuador;America Centro-Meridionale;America
58065;Monterotondo;26;24;50;Tunisia;Africa Settentrionale;Africa
58065;Monterotondo;19;19;38;Filippine;Asia Orientale;Asia
58065;Monterotondo;18;18;36;Marocco;Africa Settentrionale;Africa
58065;Monterotondo;21;15;36;Sri Lanka (ex Ceylon);Asia Centro-Meridionale;Asia
58065;Monterotondo;10;22;32;Cuba;America Centro-Meridionale;America
58065;Monterotondo;11;19;30;Brasile;America Centro-Meridionale;America
58065;Monterotondo;17;13;30;India;Asia Centro-Meridionale;Asia
58065;Monterotondo;14;15;29;Macedonia del Nord;Europa Centro-Orientale;Europa
58065;Monterotondo;6;16;22;Russa, Federazione;Europa Centro-Orientale;Europa
58065;Monterotondo;2;20;22;Spagna;Unione Europea;Europa
58065;Monterotondo;15;6;21;Senegal;Africa Occidentale;Africa
58065;Monterotondo;10;9;19;Colombia;America Centro-Meridionale;America
58065;Monterotondo;8;11;19;Congo, Repubblica democratica del (ex Zaire);Africa Centro-Meridionale;Africa
58065;Monterotondo;6;13;19;Francia;Unione Europea;Europa
58065;Monterotondo;7;10;17;Bulgaria;Unione Europea;Europa
58065;Monterotondo;6;11;17;Camerun;Africa Centro-Meridionale;Africa
58065;Monterotondo;10;7;17;Regno Unito;Altri paesi europei;Europa
58065;Monterotondo;9;7;16;Etiopia;Africa Orientale;Africa
58065;Monterotondo;5;10;15;Congo (Repubblica del);Africa Centro-Meridionale;Africa
58065;Monterotondo;2;12;14;Bolivia;America Centro-Meridionale;America
58065;Monterotondo;5;8;13;Corea, Repubblica (Corea del Sud);Asia Orientale;Asia
58065;Monterotondo;4;9;13;El Salvador;America Centro-Meridionale;America
58065;Monterotondo;6;6;12;Dominicana, Repubblica;America Centro-Meridionale;America
58065;Monterotondo;5;7;12;Germania;Unione Europea;Europa
58065;Monterotondo;7;5;12;Portogallo;Unione Europea;Europa
58065;Monterotondo;7;4;11;Kosovo;Europa Centro-Orientale;Europa
58065;Monterotondo;7;3;10;Argentina;America Centro-Meridionale;America
58065;Monterotondo;6;4;10;Iran, Repubblica Islamica del;Asia Occidentale;Asia
58065;Monterotondo;3;7;10;Somalia;Africa Orientale;Africa
58065;Monterotondo;9;0;9;Afghanistan;Asia Centro-Meridionale;Asia
58065;Monterotondo;4;5;9;Capo Verde;Africa Occidentale;Africa
58065;Monterotondo;4;5;9;Venezuela;America Centro-Meridionale;America
58065;Monterotondo;6;2;8;Algeria;Africa Settentrionale;Africa
58065;Monterotondo;5;3;8;Bosnia-Erzegovina;Europa Centro-Orientale;Europa
58065;Monterotondo;1;7;8;Georgia;Asia Occidentale;Asia
58065;Monterotondo;3;5;8;Grecia;Unione Europea;Europa
58065;Monterotondo;4;3;7;Burkina Faso (ex Alto Volta);Africa Occidentale;Africa
58065;Monterotondo;6;1;7;Gambia;Africa Occidentale;Africa
58065;Monterotondo;6;1;7;Siria;Asia Occidentale;Asia
58065;Monterotondo;2;4;6;Mali;Africa Occidentale;Africa
58065;Monterotondo;1;5;6;Messico;America Centro-Meridionale;America
58065;Monterotondo;0;5;5;Bielorussia;Europa Centro-Orientale;Europa
58065;Monterotondo;2;3;5;Eritrea;Africa Orientale;Africa
58065;Monterotondo;0;5;5;Kazakhstan;Asia Centro-Meridionale;Asia
58065;Monterotondo;4;1;5;Territori dell'Autonomia Palestinese;Asia Occidentale;Asia
58065;Monterotondo;0;4;4;Belgio;Unione Europea;Europa
58065;Monterotondo;3;1;4;Costa d'Avorio;Africa Occidentale;Africa
58065;Monterotondo;0;4;4;Giappone;Asia Orientale;Asia
58065;Monterotondo;1;3;4;Niger;Africa Occidentale;Africa
58065;Monterotondo;1;3;4;Stati Uniti d'America;America Settentrionale;America
58065;Monterotondo;1;2;3;Benin (ex Dahomey);Africa Occidentale;Africa
58065;Monterotondo;3;0;3;Guatemala;America Centro-Meridionale;America
58065;Monterotondo;1;2;3;Lituania;Unione Europea;Europa
58065;Monterotondo;0;3;3;Mozambico;Africa Orientale;Africa
58065;Monterotondo;0;3;3;Paesi Bassi;Unione Europea;Europa
58065;Monterotondo;1;2;3;Svezia;Unione Europea;Europa
58065;Monterotondo;2;1;3;Svizzera;Altri paesi europei;Europa
58065;Monterotondo;0;3;3;Togo;Africa Occidentale;Africa
58065;Monterotondo;1;1;2;Ciad;Africa Centro-Meridionale;Africa
58065;Monterotondo;1;1;2;Cile;America Centro-Meridionale;America
58065;Monterotondo;2;0;2;Ghana;Africa Occidentale;Africa
58065;Monterotondo;1;1;2;Guinea;Africa Occidentale;Africa
58065;Monterotondo;0;2;2;Honduras;America Centro-Meridionale;America
58065;Monterotondo;2;0;2;Iraq;Asia Occidentale;Asia
58065;Monterotondo;1;1;2;Libano;Asia Occidentale;Asia
58065;Monterotondo;2;0;2;Libia;Africa Settentrionale;Africa
58065;Monterotondo;0;2;2;Malta;Unione Europea;Europa
58065;Monterotondo;1;1;2;Montenegro;Europa Centro-Orientale;Europa
58065;Monterotondo;0;2;2;Nicaragua;America Centro-Meridionale;America
58065;Monterotondo;1;1;2;Paraguay;America Centro-Meridionale;America
58065;Monterotondo;2;0;2;Sudan;Africa Settentrionale;Africa
58065;Monterotondo;0;2;2;Ungheria;Unione Europea;Europa
58065;Monterotondo;0;1;1;Armenia;Asia Occidentale;Asia
58065;Monterotondo;0;1;1;Burundi;Africa Orientale;Africa
58065;Monterotondo;0;1;1;Canada;America Settentrionale;America
58065;Monterotondo;0;1;1;Ceca, Repubblica;Unione Europea;Europa
58065;Monterotondo;0;1;1;Costa Rica;America Centro-Meridionale;America
58065;Monterotondo;1;0;1;Dominica;America Centro-Meridionale;America
58065;Monterotondo;0;1;1;Estonia;Unione Europea;Europa
58065;Monterotondo;0;1;1;Finlandia;Unione Europea;Europa
58065;Monterotondo;1;0;1;Gabon;Africa Centro-Meridionale;Africa
58065;Monterotondo;0;1;1;Giordania;Asia Occidentale;Asia
58065;Monterotondo;0;1;1;Indonesia;Asia Orientale;Asia
58065;Monterotondo;0;1;1;Israele;Asia Occidentale;Asia
58065;Monterotondo;0;1;1;Kirghizistan;Asia Centro-Meridionale;Asia
58065;Monterotondo;0;1;1;Malawi;Africa Orientale;Africa
58065;Monterotondo;0;1;1;Norvegia;Altri paesi europei;Europa
58065;Monterotondo;0;1;1;San Marino;Altri paesi europei;Europa
58065;Monterotondo;0;1;1;Seychelles;Africa Orientale;Africa
58065;Monterotondo;0;1;1;Slovacchia;Unione Europea;Europa
58065;Monterotondo;1;0;1;Tanzania;Africa Orientale;Africa
58065;Monterotondo;0;1;1;Thailandia;Asia Orientale;Asia
58065;Monterotondo;1;0;1;Turchia;Europa Centro-Orientale;Europa
58065;Monterotondo;0;1;1;Vietnam;Asia Orientale;Asia
58066;Montorio Romano;39;35;74;Romania;Unione Europea;Europa
58066;Montorio Romano;23;19;42;Albania;Europa Centro-Orientale;Europa
58066;Montorio Romano;21;10;31;Marocco;Africa Settentrionale;Africa
58066;Montorio Romano;9;7;16;Filippine;Asia Orientale;Asia
58066;Montorio Romano;6;8;14;Moldova;Europa Centro-Orientale;Europa
58066;Montorio Romano;7;5;12;Macedonia del Nord;Europa Centro-Orientale;Europa
58066;Montorio Romano;2;4;6;Ucraina;Europa Centro-Orientale;Europa
58066;Montorio Romano;2;2;4;Bulgaria;Unione Europea;Europa
58066;Montorio Romano;1;3;4;Colombia;America Centro-Meridionale;America
58066;Montorio Romano;2;0;2;Bangladesh;Asia Centro-Meridionale;Asia
58066;Montorio Romano;0;2;2;Nicaragua;America Centro-Meridionale;America
58066;Montorio Romano;1;1;2;Polonia;Unione Europea;Europa
58066;Montorio Romano;1;0;1;Algeria;Africa Settentrionale;Africa
58066;Montorio Romano;0;1;1;Bosnia-Erzegovina;Europa Centro-Orientale;Europa
58066;Montorio Romano;0;1;1;Croazia;Unione Europea;Europa
58066;Montorio Romano;0;1;1;Iran, Repubblica Islamica del;Asia Occidentale;Asia
58066;Montorio Romano;0;1;1;Perù;America Centro-Meridionale;America
58066;Montorio Romano;1;0;1;Regno Unito;Altri paesi europei;Europa
58066;Montorio Romano;1;0;1;Senegal;Africa Occidentale;Africa
58067;Moricone;34;50;84;Romania;Unione Europea;Europa
58067;Moricone;22;16;38;Albania;Europa Centro-Orientale;Europa
58067;Moricone;17;12;29;Macedonia del Nord;Europa Centro-Orientale;Europa
58067;Moricone;5;6;11;Polonia;Unione Europea;Europa
58067;Moricone;1;4;5;Moldova;Europa Centro-Orientale;Europa
58067;Moricone;2;2;4;Brasile;America Centro-Meridionale;America
58067;Moricone;0;4;4;Marocco;Africa Settentrionale;Africa
58067;Moricone;2;2;4;Siria;Asia Occidentale;Asia
58067;Moricone;1;2;3;Bulgaria;Unione Europea;Europa
58067;Moricone;1;2;3;Georgia;Asia Occidentale;Asia
58067;Moricone;2;1;3;Pakistan;Asia Centro-Meridionale;Asia
58067;Moricone;1;1;2;Colombia;America Centro-Meridionale;America
58067;Moricone;0;2;2;Regno Unito;Altri paesi europei;Europa
58067;Moricone;1;1;2;Spagna;Unione Europea;Europa
58067;Moricone;0;2;2;Ucraina;Europa Centro-Orientale;Europa
58067;Moricone;0;1;1;Algeria;Africa Settentrionale;Africa
58067;Moricone;0;1;1;Argentina;America Centro-Meridionale;America
58067;Moricone;1;0;1;Bosnia-Erzegovina;Europa Centro-Orientale;Europa
58067;Moricone;0;1;1;Croazia;Unione Europea;Europa
58067;Moricone;0;1;1;Francia;Unione Europea;Europa
58067;Moricone;0;1;1;Russa, Federazione;Europa Centro-Orientale;Europa
58067;Moricone;1;0;1;Senegal;Africa Occidentale;Africa
58067;Moricone;0;1;1;Ungheria;Unione Europea;Europa
58067;Moricone;1;0;1;Venezuela;America Centro-Meridionale;America
58068;Morlupo;300;319;619;Romania;Unione Europea;Europa
58068;Morlupo;28;48;76;Moldova;Europa Centro-Orientale;Europa
58068;Morlupo;37;22;59;Albania;Europa Centro-Orientale;Europa
58068;Morlupo;25;28;53;Sri Lanka (ex Ceylon);Asia Centro-Meridionale;Asia
58068;Morlupo;17;27;44;Polonia;Unione Europea;Europa
58068;Morlupo;17;26;43;Ucraina;Europa Centro-Orientale;Europa
58068;Morlupo;23;19;42;Filippine;Asia Orientale;Asia
58068;Morlupo;24;9;33;Egitto;Africa Settentrionale;Africa
58068;Morlupo;11;14;25;Perù;America Centro-Meridionale;America
58068;Morlupo;12;12;24;Ecuador;America Centro-Meridionale;America
58068;Morlupo;12;12;24;Iran, Repubblica Islamica del;Asia Occidentale;Asia
58068;Morlupo;13;11;24;Marocco;Africa Settentrionale;Africa
58068;Morlupo;14;9;23;Tunisia;Africa Settentrionale;Africa
58068;Morlupo;15;7;22;Macedonia del Nord;Europa Centro-Orientale;Europa
58068;Morlupo;7;4;11;Bangladesh;Asia Centro-Meridionale;Asia
58068;Morlupo;4;7;11;Stati Uniti d'America;America Settentrionale;America
58068;Morlupo;5;5;10;Cinese, Repubblica Popolare;Asia Orientale;Asia
58068;Morlupo;5;5;10;Regno Unito;Altri paesi europei;Europa
58068;Morlupo;5;4;9;India;Asia Centro-Meridionale;Asia
58068;Morlupo;7;1;8;Nigeria;Africa Occidentale;Africa
58068;Morlupo;1;5;6;Brasile;America Centro-Meridionale;America
58068;Morlupo;4;2;6;Bulgaria;Unione Europea;Europa
58068;Morlupo;1;5;6;El Salvador;America Centro-Meridionale;America
58068;Morlupo;1;5;6;Germania;Unione Europea;Europa
58068;Morlupo;6;0;6;Mali;Africa Occidentale;Africa
58068;Morlupo;1;5;6;Spagna;Unione Europea;Europa
58068;Morlupo;3;2;5;Costa d'Avorio;Africa Occidentale;Africa
58068;Morlupo;1;4;5;Cuba;America Centro-Meridionale;America
58068;Morlupo;3;2;5;Senegal;Africa Occidentale;Africa
58068;Morlupo;2;3;5;Ungheria;Unione Europea;Europa
58068;Morlupo;3;1;4;Colombia;America Centro-Meridionale;America
58068;Morlupo;2;2;4;Francia;Unione Europea;Europa
58068;Morlupo;3;1;4;Giordania;Asia Occidentale;Asia
58068;Morlupo;3;1;4;Kosovo;Europa Centro-Orientale;Europa
58068;Morlupo;1;3;4;Libano;Asia Occidentale;Asia
58068;Morlupo;1;3;4;Serbia, Repubblica di;Europa Centro-Orientale;Europa
58068;Morlupo;0;3;3;Belgio;Unione Europea;Europa
58068;Morlupo;1;2;3;Dominicana, Repubblica;America Centro-Meridionale;America
58068;Morlupo;1;2;3;Kazakhstan;Asia Centro-Meridionale;Asia
58068;Morlupo;1;2;3;Paesi Bassi;Unione Europea;Europa
58068;Morlupo;1;2;3;Taiwan (ex Formosa);Asia Orientale;Asia
58068;Morlupo;1;1;2;Algeria;Africa Settentrionale;Africa
58068;Morlupo;1;1;2;Capo Verde;Africa Occidentale;Africa
58068;Morlupo;2;0;2;Gambia;Africa Occidentale;Africa
58068;Morlupo;0;2;2;Georgia;Asia Occidentale;Asia
58068;Morlupo;1;1;2;Giappone;Asia Orientale;Asia
58068;Morlupo;2;0;2;Madagascar;Africa Orientale;Africa
58068;Morlupo;2;0;2;Pakistan;Asia Centro-Meridionale;Asia
58068;Morlupo;1;1;2;Russa, Federazione;Europa Centro-Orientale;Europa
58068;Morlupo;1;1;2;Slovenia;Unione Europea;Europa
58068;Morlupo;1;1;2;Somalia;Africa Orientale;Africa
58068;Morlupo;0;2;2;Svezia;Unione Europea;Europa
58068;Morlupo;1;1;2;Turchia;Europa Centro-Orientale;Europa
58068;Morlupo;0;1;1;Austria;Unione Europea;Europa
58068;Morlupo;0;1;1;Azerbaigian;Asia Occidentale;Asia
58068;Morlupo;0;1;1;Bielorussia;Europa Centro-Orientale;Europa
58068;Morlupo;1;0;1;Burkina Faso (ex Alto Volta);Africa Occidentale;Africa
58068;Morlupo;1;0;1;Camerun;Africa Centro-Meridionale;Africa
58068;Morlupo;1;0;1;Centrafricana, Repubblica;Africa Centro-Meridionale;Africa
58068;Morlupo;0;1;1;Cile;America Centro-Meridionale;America
58068;Morlupo;1;0;1;Congo (Repubblica del);Africa Centro-Meridionale;Africa
58068;Morlupo;1;0;1;Croazia;Unione Europea;Europa
58068;Morlupo;0;1;1;Eritrea;Africa Orientale;Africa
58068;Morlupo;1;0;1;Etiopia;Africa Orientale;Africa
58068;Morlupo;0;1;1;Finlandia;Unione Europea;Europa
58068;Morlupo;0;1;1;Grecia;Unione Europea;Europa
58068;Morlupo;1;0;1;Guinea;Africa Occidentale;Africa
58068;Morlupo;1;0;1;Guinea Bissau;Africa Occidentale;Africa
58068;Morlupo;1;0;1;Honduras;America Centro-Meridionale;America
58068;Morlupo;1;0;1;Irlanda;Unione Europea;Europa
58068;Morlupo;0;1;1;Kenya;Africa Orientale;Africa
58068;Morlupo;0;1;1;Libia;Africa Settentrionale;Africa
58068;Morlupo;0;1;1;Nuova Zelanda;Oceania;Oceania
58068;Morlupo;0;1;1;Paraguay;America Centro-Meridionale;America
58068;Morlupo;0;1;1;Portogallo;Unione Europea;Europa
58068;Morlupo;0;1;1;Slovacchia;Unione Europea;Europa
58068;Morlupo;0;1;1;Thailandia;Asia Orientale;Asia
58069;Nazzano;39;29;68;Romania;Unione Europea;Europa
58069;Nazzano;13;9;22;Algeria;Africa Settentrionale;Africa
58069;Nazzano;17;3;20;Bangladesh;Asia Centro-Meridionale;Asia
58069;Nazzano;7;5;12;Sri Lanka (ex Ceylon);Asia Centro-Meridionale;Asia
58069;Nazzano;1;7;8;Ucraina;Europa Centro-Orientale;Europa
58069;Nazzano;0;3;3;Colombia;America Centro-Meridionale;America
58069;Nazzano;3;0;3;Egitto;Africa Settentrionale;Africa
58069;Nazzano;2;1;3;Marocco;Africa Settentrionale;Africa
58069;Nazzano;2;1;3;Polonia;Unione Europea;Europa
58069;Nazzano;2;0;2;Albania;Europa Centro-Orientale;Europa
58069;Nazzano;0;2;2;Brasile;America Centro-Meridionale;America
58069;Nazzano;1;1;2;Francia;Unione Europea;Europa
58069;Nazzano;1;1;2;Germania;Unione Europea;Europa
58069;Nazzano;1;1;2;Macedonia del Nord;Europa Centro-Orientale;Europa
58069;Nazzano;2;0;2;Pakistan;Asia Centro-Meridionale;Asia
58069;Nazzano;1;0;1;Canada;America Settentrionale;America
58069;Nazzano;0;1;1;Ceca, Repubblica;Unione Europea;Europa
58069;Nazzano;0;1;1;Filippine;Asia Orientale;Asia
58069;Nazzano;1;0;1;Ghana;Africa Occidentale;Africa
58069;Nazzano;1;0;1;Nigeria;Africa Occidentale;Africa
58069;Nazzano;1;0;1;Regno Unito;Altri paesi europei;Europa
58070;Nemi;24;32;56;Romania;Unione Europea;Europa
58070;Nemi;16;13;29;Albania;Europa Centro-Orientale;Europa
58070;Nemi;6;2;8;India;Asia Centro-Meridionale;Asia
58070;Nemi;4;1;5;Germania;Unione Europea;Europa
58070;Nemi;1;4;5;Regno Unito;Altri paesi europei;Europa
58070;Nemi;2;3;5;Ucraina;Europa Centro-Orientale;Europa
58070;Nemi;4;0;4;Marocco;Africa Settentrionale;Africa
58070;Nemi;4;0;4;Perù;America Centro-Meridionale;America
58070;Nemi;3;0;3;Egitto;Africa Settentrionale;Africa
58070;Nemi;2;0;2;Bangladesh;Asia Centro-Meridionale;Asia
58070;Nemi;0;2;2;Brasile;America Centro-Meridionale;America
58070;Nemi;1;1;2;Cinese, Repubblica Popolare;Asia Orientale;Asia
58070;Nemi;2;0;2;Colombia;America Centro-Meridionale;America
58070;Nemi;2;0;2;Cuba;America Centro-Meridionale;America
58070;Nemi;1;1;2;Danimarca;Unione Europea;Europa
58070;Nemi;1;1;2;Paesi Bassi;Unione Europea;Europa
58070;Nemi;0;2;2;Russa, Federazione;Europa Centro-Orientale;Europa
58070;Nemi;0;2;2;Spagna;Unione Europea;Europa
58070;Nemi;0;1;1;Argentina;America Centro-Meridionale;America
58070;Nemi;1;0;1;Austria;Unione Europea;Europa
58070;Nemi;0;1;1;Bulgaria;Unione Europea;Europa
58070;Nemi;1;0;1;Cile;America Centro-Meridionale;America
58070;Nemi;0;1;1;Ecuador;America Centro-Meridionale;America
58070;Nemi;0;1;1;Etiopia;Africa Orientale;Africa
58070;Nemi;0;1;1;Indonesia;Asia Orientale;Asia
58070;Nemi;1;0;1;Iraq;Asia Occidentale;Asia
58070;Nemi;1;0;1;Moldova;Europa Centro-Orientale;Europa
58070;Nemi;0;1;1;Nigeria;Africa Occidentale;Africa
58070;Nemi;1;0;1;Stati Uniti d'America;America Settentrionale;America
58070;Nemi;0;1;1;Svizzera;Altri paesi europei;Europa
58070;Nemi;1;0;1;Uruguay;America Centro-Meridionale;America
58071;Nerola;39;55;94;Romania;Unione Europea;Europa
58071;Nerola;13;11;24;Albania;Europa Centro-Orientale;Europa
58071;Nerola;5;8;13;Polonia;Unione Europea;Europa
58071;Nerola;1;6;7;Ucraina;Europa Centro-Orientale;Europa
58071;Nerola;3;2;5;Macedonia del Nord;Europa Centro-Orientale;Europa
58071;Nerola;3;1;4;Bangladesh;Asia Centro-Meridionale;Asia
58071;Nerola;2;2;4;Nepal;Asia Centro-Meridionale;Asia
58071;Nerola;0;4;4;Russa, Federazione;Europa Centro-Orientale;Europa
58071;Nerola;2;1;3;Capo Verde;Africa Occidentale;Africa
58071;Nerola;0;3;3;Congo (Repubblica del);Africa Centro-Meridionale;Africa
58071;Nerola;1;2;3;Ecuador;America Centro-Meridionale;America
58071;Nerola;2;1;3;Egitto;Africa Settentrionale;Africa
58071;Nerola;0;3;3;Etiopia;Africa Orientale;Africa
58071;Nerola;1;1;2;Cinese, Repubblica Popolare;Asia Orientale;Asia
58071;Nerola;1;1;2;Filippine;Asia Orientale;Asia
58071;Nerola;2;0;2;Pakistan;Asia Centro-Meridionale;Asia
58071;Nerola;1;1;2;Stati Uniti d'America;America Settentrionale;America
58071;Nerola;0;1;1;Argentina;America Centro-Meridionale;America
58071;Nerola;0;1;1;Belgio;Unione Europea;Europa
58071;Nerola;0;1;1;Brasile;America Centro-Meridionale;America
58071;Nerola;1;0;1;Canada;America Settentrionale;America
58071;Nerola;0;1;1;Ceca, Repubblica;Unione Europea;Europa
58071;Nerola;0;1;1;Colombia;America Centro-Meridionale;America
58071;Nerola;1;0;1;Giordania;Asia Occidentale;Asia
58071;Nerola;0;1;1;Moldova;Europa Centro-Orientale;Europa
58071;Nerola;0;1;1;Perù;America Centro-Meridionale;America
58071;Nerola;0;1;1;Regno Unito;Altri paesi europei;Europa
58071;Nerola;1;0;1;Senegal;Africa Occidentale;Africa
58071;Nerola;1;0;1;Somalia;Africa Orientale;Africa
58071;Nerola;1;0;1;Spagna;Unione Europea;Europa
58072;Nettuno;480;576;1056;Romania;Unione Europea;Europa
58072;Nettuno;553;186;739;India;Asia Centro-Meridionale;Asia
58072;Nettuno;255;313;568;Bulgaria;Unione Europea;Europa
58072;Nettuno;181;97;278;Tunisia;Africa Settentrionale;Africa
58072;Nettuno;224;45;269;Bangladesh;Asia Centro-Meridionale;Asia
58072;Nettuno;122;56;178;Marocco;Africa Settentrionale;Africa
58072;Nettuno;72;73;145;Cinese, Repubblica Popolare;Asia Orientale;Asia
58072;Nettuno;116;26;142;Egitto;Africa Settentrionale;Africa
58072;Nettuno;36;104;140;Ucraina;Europa Centro-Orientale;Europa
58072;Nettuno;80;44;124;Nigeria;Africa Occidentale;Africa
58072;Nettuno;42;74;116;Polonia;Unione Europea;Europa
58072;Nettuno;61;6;67;Pakistan;Asia Centro-Meridionale;Asia
58072;Nettuno;27;31;58;Albania;Europa Centro-Orientale;Europa
58072;Nettuno;41;7;48;Senegal;Africa Occidentale;Africa
58072;Nettuno;12;34;46;Cuba;America Centro-Meridionale;America
58072;Nettuno;13;33;46;Moldova;Europa Centro-Orientale;Europa
58072;Nettuno;15;29;44;Russa, Federazione;Europa Centro-Orientale;Europa
58072;Nettuno;29;14;43;Turchia;Europa Centro-Orientale;Europa
58072;Nettuno;17;23;40;Brasile;America Centro-Meridionale;America
58072;Nettuno;35;0;35;Gambia;Africa Occidentale;Africa
58072;Nettuno;25;0;25;Mali;Africa Occidentale;Africa
58072;Nettuno;15;9;24;Algeria;Africa Settentrionale;Africa
58072;Nettuno;7;15;22;Francia;Unione Europea;Europa
58072;Nettuno;6;15;21;Perù;America Centro-Meridionale;America
58072;Nettuno;6;12;18;Colombia;America Centro-Meridionale;America
58072;Nettuno;10;8;18;Regno Unito;Altri paesi europei;Europa
58072;Nettuno;4;13;17;Filippine;Asia Orientale;Asia
58072;Nettuno;4;11;15;Spagna;Unione Europea;Europa
58072;Nettuno;11;3;14;Camerun;Africa Centro-Meridionale;Africa
58072;Nettuno;4;9;13;Bielorussia;Europa Centro-Orientale;Europa
58072;Nettuno;7;5;12;Croazia;Unione Europea;Europa
58072;Nettuno;5;7;12;Kosovo;Europa Centro-Orientale;Europa
58072;Nettuno;10;2;12;Siria;Asia Occidentale;Asia
58072;Nettuno;7;4;11;Stati Uniti d'America;America Settentrionale;America
58072;Nettuno;10;0;10;Costa d'Avorio;Africa Occidentale;Africa
58072;Nettuno;10;0;10;Guinea;Africa Occidentale;Africa
58072;Nettuno;2;8;10;Venezuela;America Centro-Meridionale;America
58072;Nettuno;4;5;9;Bosnia-Erzegovina;Europa Centro-Orientale;Europa
58072;Nettuno;3;6;9;Germania;Unione Europea;Europa
58072;Nettuno;3;5;8;Dominicana, Repubblica;America Centro-Meridionale;America
58072;Nettuno;3;4;7;Argentina;America Centro-Meridionale;America
58072;Nettuno;4;3;7;Eritrea;Africa Orientale;Africa
58072;Nettuno;4;3;7;Ghana;Africa Occidentale;Africa
58072;Nettuno;1;6;7;Giappone;Asia Orientale;Asia
58072;Nettuno;4;3;7;Serbia, Repubblica di;Europa Centro-Orientale;Europa
58072;Nettuno;3;3;6;Libia;Africa Settentrionale;Africa
58072;Nettuno;1;5;6;Thailandia;Asia Orientale;Asia
58072;Nettuno;1;4;5;Ceca, Repubblica;Unione Europea;Europa
58072;Nettuno;4;1;5;Iraq;Asia Occidentale;Asia
58072;Nettuno;4;0;4;Burkina Faso (ex Alto Volta);Africa Occidentale;Africa
58072;Nettuno;1;3;4;Capo Verde;Africa Occidentale;Africa
58072;Nettuno;1;3;4;Danimarca;Unione Europea;Europa
58072;Nettuno;3;1;4;Togo;Africa Occidentale;Africa
58072;Nettuno;0;4;4;Ungheria;Unione Europea;Europa
58072;Nettuno;3;0;3;Afghanistan;Asia Centro-Meridionale;Asia
58072;Nettuno;1;2;3;Belgio;Unione Europea;Europa
58072;Nettuno;0;3;3;Etiopia;Africa Orientale;Africa
58072;Nettuno;1;2;3;Georgia;Asia Occidentale;Asia
58072;Nettuno;1;2;3;Grecia;Unione Europea;Europa
58072;Nettuno;3;0;3;Guinea Bissau;Africa Occidentale;Africa
58072;Nettuno;1;2;3;Kazakhstan;Asia Centro-Meridionale;Asia
58072;Nettuno;2;1;3;Macedonia del Nord;Europa Centro-Orientale;Europa
58072;Nettuno;1;2;3;Slovacchia;Unione Europea;Europa
58072;Nettuno;2;1;3;Sri Lanka (ex Ceylon);Asia Centro-Meridionale;Asia
58072;Nettuno;0;2;2;Australia;Oceania;Oceania
58072;Nettuno;2;0;2;Congo (Repubblica del);Africa Centro-Meridionale;Africa
58072;Nettuno;0;2;2;Corea, Repubblica (Corea del Sud);Asia Orientale;Asia
58072;Nettuno;1;1;2;Ecuador;America Centro-Meridionale;America
58072;Nettuno;0;2;2;Indonesia;Asia Orientale;Asia
58072;Nettuno;2;0;2;Iran, Repubblica Islamica del;Asia Occidentale;Asia
58072;Nettuno;1;1;2;Niger;Africa Occidentale;Africa
58072;Nettuno;0;2;2;Paesi Bassi;Unione Europea;Europa
58072;Nettuno;1;1;2;Portogallo;Unione Europea;Europa
58072;Nettuno;2;0;2;Sierra Leone;Africa Occidentale;Africa
58072;Nettuno;2;0;2;Sudan;Africa Settentrionale;Africa
58072;Nettuno;1;1;2;Svezia;Unione Europea;Europa
58072;Nettuno;2;0;2;Territori dell'Autonomia Palestinese;Asia Occidentale;Asia
58072;Nettuno;1;1;2;Uruguay;America Centro-Meridionale;America
58072;Nettuno;0;1;1;Angola;Africa Centro-Meridionale;Africa
58072;Nettuno;0;1;1;Apolide;;
58072;Nettuno;0;1;1;Armenia;Asia Occidentale;Asia
58072;Nettuno;1;0;1;Austria;Unione Europea;Europa
58072;Nettuno;1;0;1;Azerbaigian;Asia Occidentale;Asia
58072;Nettuno;1;0;1;Cile;America Centro-Meridionale;America
58072;Nettuno;0;1;1;Congo, Repubblica democratica del (ex Zaire);Africa Centro-Meridionale;Africa
58072;Nettuno;0;1;1;Dominica;America Centro-Meridionale;America
58072;Nettuno;0;1;1;El Salvador;America Centro-Meridionale;America
58072;Nettuno;0;1;1;Finlandia;Unione Europea;Europa
58072;Nettuno;0;1;1;Giordania;Asia Occidentale;Asia
58072;Nettuno;0;1;1;Haiti;America Centro-Meridionale;America
58072;Nettuno;0;1;1;Honduras;America Centro-Meridionale;America
58072;Nettuno;0;1;1;Kenya;Africa Orientale;Africa
58072;Nettuno;1;0;1;Libano;Asia Occidentale;Asia
58072;Nettuno;1;0;1;Liberia;Africa Occidentale;Africa
58072;Nettuno;1;0;1;Madagascar;Africa Orientale;Africa
58072;Nettuno;0;1;1;Malaysia;Asia Orientale;Asia
58072;Nettuno;0;1;1;Messico;America Centro-Meridionale;America
58072;Nettuno;0;1;1;Montenegro;Europa Centro-Orientale;Europa
58072;Nettuno;0;1;1;Paraguay;America Centro-Meridionale;America
58072;Nettuno;0;1;1;Singapore;Asia Orientale;Asia
58072;Nettuno;1;0;1;Somalia;Africa Orientale;Africa
58072;Nettuno;0;1;1;Sud Africa;Africa Centro-Meridionale;Africa
58072;Nettuno;0;1;1;Svizzera;Altri paesi europei;Europa
58072;Nettuno;1;0;1;Tonga;Oceania;Oceania
58073;Olevano Romano;140;131;271;Romania;Unione Europea;Europa
58073;Olevano Romano;62;48;110;Albania;Europa Centro-Orientale;Europa
58073;Olevano Romano;45;1;46;Egitto;Africa Settentrionale;Africa
58073;Olevano Romano;16;7;23;Bangladesh;Asia Centro-Meridionale;Asia
58073;Olevano Romano;8;4;12;Iraq;Asia Occidentale;Asia
58073;Olevano Romano;3;8;11;Ucraina;Europa Centro-Orientale;Europa
58073;Olevano Romano;5;3;8;Cinese, Repubblica Popolare;Asia Orientale;Asia
58073;Olevano Romano;2;3;5;Bielorussia;Europa Centro-Orientale;Europa
58073;Olevano Romano;2;3;5;Filippine;Asia Orientale;Asia
58073;Olevano Romano;5;0;5;India;Asia Centro-Meridionale;Asia
58073;Olevano Romano;2;3;5;Moldova;Europa Centro-Orientale;Europa
58073;Olevano Romano;0;5;5;Polonia;Unione Europea;Europa
58073;Olevano Romano;2;2;4;Germania;Unione Europea;Europa
58073;Olevano Romano;2;2;4;Perù;America Centro-Meridionale;America
58073;Olevano Romano;1;2;3;Danimarca;Unione Europea;Europa
58073;Olevano Romano;1;2;3;Macedonia del Nord;Europa Centro-Orientale;Europa
58073;Olevano Romano;2;1;3;Nigeria;Africa Occidentale;Africa
58073;Olevano Romano;1;1;2;Argentina;America Centro-Meridionale;America
58073;Olevano Romano;1;1;2;Burundi;Africa Orientale;Africa
58073;Olevano Romano;2;0;2;Iran, Repubblica Islamica del;Asia Occidentale;Asia
58073;Olevano Romano;2;0;2;Kirghizistan;Asia Centro-Meridionale;Asia
58073;Olevano Romano;0;2;2;Madagascar;Africa Orientale;Africa
58073;Olevano Romano;2;0;2;Marocco;Africa Settentrionale;Africa
58073;Olevano Romano;2;0;2;Regno Unito;Altri paesi europei;Europa
58073;Olevano Romano;1;1;2;Russa, Federazione;Europa Centro-Orientale;Europa
58073;Olevano Romano;1;1;2;Somalia;Africa Orientale;Africa
58073;Olevano Romano;1;1;2;Spagna;Unione Europea;Europa
58073;Olevano Romano;2;0;2;Stati Uniti d'America;America Settentrionale;America
58073;Olevano Romano;2;0;2;Tunisia;Africa Settentrionale;Africa
58073;Olevano Romano;0;1;1;Algeria;Africa Settentrionale;Africa
58073;Olevano Romano;0;1;1;Brasile;America Centro-Meridionale;America
58073;Olevano Romano;0;1;1;Capo Verde;Africa Occidentale;Africa
58073;Olevano Romano;0;1;1;Centrafricana, Repubblica;Africa Centro-Meridionale;Africa
58073;Olevano Romano;0;1;1;Dominicana, Repubblica;America Centro-Meridionale;America
58073;Olevano Romano;0;1;1;Eritrea;Africa Orientale;Africa
58073;Olevano Romano;1;0;1;Gambia;Africa Occidentale;Africa
58073;Olevano Romano;0;1;1;Irlanda;Unione Europea;Europa
58073;Olevano Romano;0;1;1;Mozambico;Africa Orientale;Africa
58073;Olevano Romano;0;1;1;Nicaragua;America Centro-Meridionale;America
58073;Olevano Romano;0;1;1;Svezia;Unione Europea;Europa
58073;Olevano Romano;0;1;1;Turchia;Europa Centro-Orientale;Europa
58073;Olevano Romano;1;0;1;Ungheria;Unione Europea;Europa
58073;Olevano Romano;0;1;1;Venezuela;America Centro-Meridionale;America
58074;Palestrina;767;803;1570;Romania;Unione Europea;Europa
58074;Palestrina;109;103;212;Albania;Europa Centro-Orientale;Europa
58074;Palestrina;62;39;101;Nigeria;Africa Occidentale;Africa
58074;Palestrina;78;21;99;Egitto;Africa Settentrionale;Africa
58074;Palestrina;55;23;78;Marocco;Africa Settentrionale;Africa
58074;Palestrina;22;27;49;Cinese, Repubblica Popolare;Asia Orientale;Asia
58074;Palestrina;15;29;44;Moldova;Europa Centro-Orientale;Europa
58074;Palestrina;14;25;39;Polonia;Unione Europea;Europa
58074;Palestrina;5;22;27;Ucraina;Europa Centro-Orientale;Europa
58074;Palestrina;7;18;25;Brasile;America Centro-Meridionale;America
58074;Palestrina;13;5;18;Pakistan;Asia Centro-Meridionale;Asia
58074;Palestrina;14;3;17;Bangladesh;Asia Centro-Meridionale;Asia
58074;Palestrina;8;8;16;Perù;America Centro-Meridionale;America
58074;Palestrina;2;14;16;Russa, Federazione;Europa Centro-Orientale;Europa
58074;Palestrina;5;9;14;Colombia;America Centro-Meridionale;America
58074;Palestrina;7;7;14;Regno Unito;Altri paesi europei;Europa
58074;Palestrina;5;8;13;Filippine;Asia Orientale;Asia
58074;Palestrina;6;5;11;Bulgaria;Unione Europea;Europa
58074;Palestrina;5;5;10;Macedonia del Nord;Europa Centro-Orientale;Europa
58074;Palestrina;1;8;9;Francia;Unione Europea;Europa
58074;Palestrina;1;7;8;Cuba;America Centro-Meridionale;America
58074;Palestrina;4;4;8;Ecuador;America Centro-Meridionale;America
58074;Palestrina;2;5;7;Capo Verde;Africa Occidentale;Africa
58074;Palestrina;4;3;7;India;Asia Centro-Meridionale;Asia
58074;Palestrina;1;5;6;Bielorussia;Europa Centro-Orientale;Europa
58074;Palestrina;3;3;6;Costa d'Avorio;Africa Occidentale;Africa
58074;Palestrina;3;3;6;Costa Rica;America Centro-Meridionale;America
58074;Palestrina;1;5;6;Estonia;Unione Europea;Europa
58074;Palestrina;4;2;6;Tunisia;Africa Settentrionale;Africa
58074;Palestrina;4;1;5;Kosovo;Europa Centro-Orientale;Europa
58074;Palestrina;1;4;5;Stati Uniti d'America;America Settentrionale;America
58074;Palestrina;1;3;4;Argentina;America Centro-Meridionale;America
58074;Palestrina;0;4;4;Dominicana, Repubblica;America Centro-Meridionale;America
58074;Palestrina;2;2;4;Georgia;Asia Occidentale;Asia
58074;Palestrina;2;2;4;Germania;Unione Europea;Europa
58074;Palestrina;2;2;4;Kenya;Africa Orientale;Africa
58074;Palestrina;3;1;4;Paesi Bassi;Unione Europea;Europa
58074;Palestrina;2;2;4;Portogallo;Unione Europea;Europa
58074;Palestrina;1;3;4;Spagna;Unione Europea;Europa
58074;Palestrina;3;1;4;Sri Lanka (ex Ceylon);Asia Centro-Meridionale;Asia
58074;Palestrina;3;1;4;Uganda;Africa Orientale;Africa
58074;Palestrina;2;2;4;Ungheria;Unione Europea;Europa
58074;Palestrina;1;2;3;Belgio;Unione Europea;Europa
58074;Palestrina;2;1;3;Etiopia;Africa Orientale;Africa
58074;Palestrina;1;2;3;Venezuela;America Centro-Meridionale;America
58074;Palestrina;2;0;2;Camerun;Africa Centro-Meridionale;Africa
58074;Palestrina;2;0;2;Congo (Repubblica del);Africa Centro-Meridionale;Africa
58074;Palestrina;1;1;2;Croazia;Unione Europea;Europa
58074;Palestrina;0;2;2;Grecia;Unione Europea;Europa
58074;Palestrina;1;0;1;Afghanistan;Asia Centro-Meridionale;Asia
58074;Palestrina;0;1;1;Algeria;Africa Settentrionale;Africa
58074;Palestrina;1;0;1;Australia;Oceania;Oceania
58074;Palestrina;0;1;1;Ceca, Repubblica;Unione Europea;Europa
58074;Palestrina;0;1;1;Cile;America Centro-Meridionale;America
58074;Palestrina;0;1;1;Corea, Repubblica (Corea del Sud);Asia Orientale;Asia
58074;Palestrina;0;1;1;Dominica;America Centro-Meridionale;America
58074;Palestrina;0;1;1;Eritrea;Africa Orientale;Africa
58074;Palestrina;0;1;1;Finlandia;Unione Europea;Europa
58074;Palestrina;1;0;1;Ghana;Africa Occidentale;Africa
58074;Palestrina;0;1;1;Giappone;Asia Orientale;Asia
58074;Palestrina;1;0;1;Indonesia;Asia Orientale;Asia
58074;Palestrina;0;1;1;Kirghizistan;Asia Centro-Meridionale;Asia
58074;Palestrina;0;1;1;Lettonia;Unione Europea;Europa
58074;Palestrina;0;1;1;Madagascar;Africa Orientale;Africa
58074;Palestrina;0;1;1;Mali;Africa Occidentale;Africa
58074;Palestrina;1;0;1;Mauritania;Africa Occidentale;Africa
58074;Palestrina;0;1;1;Mauritius;Africa Orientale;Africa
58074;Palestrina;1;0;1;Messico;America Centro-Meridionale;America
58074;Palestrina;1;0;1;Mozambico;Africa Orientale;Africa
58074;Palestrina;1;0;1;San Marino;Altri paesi europei;Europa
58074;Palestrina;0;1;1;Somalia;Africa Orientale;Africa
58074;Palestrina;1;0;1;Tonga;Oceania;Oceania
58075;Palombara Sabina;361;400;761;Romania;Unione Europea;Europa
58075;Palombara Sabina;68;55;123;Albania;Europa Centro-Orientale;Europa
58075;Palombara Sabina;35;7;42;Egitto;Africa Settentrionale;Africa
58075;Palombara Sabina;11;30;41;Polonia;Unione Europea;Europa
58075;Palombara Sabina;7;29;36;Ucraina;Europa Centro-Orientale;Europa
58075;Palombara Sabina;13;19;32;Moldova;Europa Centro-Orientale;Europa
58075;Palombara Sabina;2;19;21;Brasile;America Centro-Meridionale;America
58075;Palombara Sabina;9;10;19;Marocco;Africa Settentrionale;Africa
58075;Palombara Sabina;6;13;19;Perù;America Centro-Meridionale;America
58075;Palombara Sabina;12;6;18;Macedonia del Nord;Europa Centro-Orientale;Europa
58075;Palombara Sabina;6;11;17;Cinese, Repubblica Popolare;Asia Orientale;Asia
58075;Palombara Sabina;2;13;15;Congo, Repubblica democratica del (ex Zaire);Africa Centro-Meridionale;Africa
58075;Palombara Sabina;5;9;14;Filippine;Asia Orientale;Asia
58075;Palombara Sabina;6;4;10;Pakistan;Asia Centro-Meridionale;Asia
58075;Palombara Sabina;1;8;9;Regno Unito;Altri paesi europei;Europa
58075;Palombara Sabina;3;6;9;Spagna;Unione Europea;Europa
58075;Palombara Sabina;6;1;7;Bangladesh;Asia Centro-Meridionale;Asia
58075;Palombara Sabina;2;5;7;Ecuador;America Centro-Meridionale;America
58075;Palombara Sabina;3;4;7;Francia;Unione Europea;Europa
58075;Palombara Sabina;3;4;7;Irlanda;Unione Europea;Europa
58075;Palombara Sabina;1;5;6;Colombia;America Centro-Meridionale;America
58075;Palombara Sabina;3;2;5;Bolivia;America Centro-Meridionale;America
58075;Palombara Sabina;2;3;5;Bulgaria;Unione Europea;Europa
58075;Palombara Sabina;0;5;5;Cuba;America Centro-Meridionale;America
58075;Palombara Sabina;3;2;5;Taiwan (ex Formosa);Asia Orientale;Asia
58075;Palombara Sabina;5;0;5;Tunisia;Africa Settentrionale;Africa
58075;Palombara Sabina;2;2;4;Congo (Repubblica del);Africa Centro-Meridionale;Africa
58075;Palombara Sabina;0;4;4;Germania;Unione Europea;Europa
58075;Palombara Sabina;1;3;4;Nigeria;Africa Occidentale;Africa
58075;Palombara Sabina;2;2;4;Paesi Bassi;Unione Europea;Europa
58075;Palombara Sabina;1;3;4;Russa, Federazione;Europa Centro-Orientale;Europa
58075;Palombara Sabina;3;0;3;Algeria;Africa Settentrionale;Africa
58075;Palombara Sabina;2;1;3;Argentina;America Centro-Meridionale;America
58075;Palombara Sabina;0;3;3;Bielorussia;Europa Centro-Orientale;Europa
58075;Palombara Sabina;1;2;3;Honduras;America Centro-Meridionale;America
58075;Palombara Sabina;1;1;2;Afghanistan;Asia Centro-Meridionale;Asia
58075;Palombara Sabina;1;1;2;Centrafricana, Repubblica;Africa Centro-Meridionale;Africa
58075;Palombara Sabina;1;1;2;Dominicana, Repubblica;America Centro-Meridionale;America
58075;Palombara Sabina;2;0;2;Ghana;Africa Occidentale;Africa
58075;Palombara Sabina;0;2;2;Giappone;Asia Orientale;Asia
58075;Palombara Sabina;2;0;2;India;Asia Centro-Meridionale;Asia
58075;Palombara Sabina;0;2;2;Messico;America Centro-Meridionale;America
58075;Palombara Sabina;1;1;2;Myanmar (ex Birmania);Asia Orientale;Asia
58075;Palombara Sabina;2;0;2;Niger;Africa Occidentale;Africa
58075;Palombara Sabina;1;1;2;Svizzera;Altri paesi europei;Europa
58075;Palombara Sabina;0;2;2;Venezuela;America Centro-Meridionale;America
58075;Palombara Sabina;0;1;1;Austria;Unione Europea;Europa
58075;Palombara Sabina;1;0;1;Bosnia-Erzegovina;Europa Centro-Orientale;Europa
58075;Palombara Sabina;1;0;1;Burkina Faso (ex Alto Volta);Africa Occidentale;Africa
58075;Palombara Sabina;1;0;1;Canada;America Settentrionale;America
58075;Palombara Sabina;0;1;1;Etiopia;Africa Orientale;Africa
58075;Palombara Sabina;0;1;1;Gabon;Africa Centro-Meridionale;Africa
58075;Palombara Sabina;0;1;1;Guinea;Africa Occidentale;Africa
58075;Palombara Sabina;0;1;1;Kazakhstan;Asia Centro-Meridionale;Asia
58075;Palombara Sabina;1;0;1;Kosovo;Europa Centro-Orientale;Europa
58075;Palombara Sabina;1;0;1;Mali;Africa Occidentale;Africa
58075;Palombara Sabina;1;0;1;Portogallo;Unione Europea;Europa
58075;Palombara Sabina;1;0;1;San Marino;Altri paesi europei;Europa
58075;Palombara Sabina;1;0;1;Senegal;Africa Occidentale;Africa
58075;Palombara Sabina;0;1;1;Somalia;Africa Orientale;Africa
58075;Palombara Sabina;1;0;1;Sri Lanka (ex Ceylon);Asia Centro-Meridionale;Asia
58075;Palombara Sabina;1;0;1;Stati Uniti d'America;America Settentrionale;America
58075;Palombara Sabina;0;1;1;Thailandia;Asia Orientale;Asia
58075;Palombara Sabina;0;1;1;Ungheria;Unione Europea;Europa
58076;Percile;13;16;29;Romania;Unione Europea;Europa
58076;Percile;1;1;2;Marocco;Africa Settentrionale;Africa
58076;Percile;0;1;1;Ecuador;America Centro-Meridionale;America
58077;Pisoniano;19;21;40;Romania;Unione Europea;Europa
58077;Pisoniano;2;13;15;Nigeria;Africa Occidentale;Africa
58077;Pisoniano;5;8;13;Albania;Europa Centro-Orientale;Europa
58077;Pisoniano;3;6;9;Guatemala;America Centro-Meridionale;America
58077;Pisoniano;2;5;7;Polonia;Unione Europea;Europa
58077;Pisoniano;3;1;4;Moldova;Europa Centro-Orientale;Europa
58077;Pisoniano;2;2;4;Ucraina;Europa Centro-Orientale;Europa
58077;Pisoniano;0;3;3;Cinese, Repubblica Popolare;Asia Orientale;Asia
58077;Pisoniano;0;3;3;Colombia;America Centro-Meridionale;America
58077;Pisoniano;0;3;3;Costa Rica;America Centro-Meridionale;America
58077;Pisoniano;2;1;3;Filippine;Asia Orientale;Asia
58077;Pisoniano;0;3;3;Messico;America Centro-Meridionale;America
58077;Pisoniano;2;1;3;Tunisia;Africa Settentrionale;Africa
58077;Pisoniano;0;3;3;Ungheria;Unione Europea;Europa
58077;Pisoniano;1;1;2;Argentina;America Centro-Meridionale;America
58077;Pisoniano;1;1;2;Bielorussia;Europa Centro-Orientale;Europa
58077;Pisoniano;0;2;2;Bulgaria;Unione Europea;Europa
58077;Pisoniano;0;2;2;Costa d'Avorio;Africa Occidentale;Africa
58077;Pisoniano;2;0;2;Perù;America Centro-Meridionale;America
58077;Pisoniano;0;2;2;Russa, Federazione;Europa Centro-Orientale;Europa
58077;Pisoniano;0;1;1;Armenia;Asia Occidentale;Asia
58077;Pisoniano;1;0;1;Brasile;America Centro-Meridionale;America
58077;Pisoniano;0;1;1;Camerun;Africa Centro-Meridionale;Africa
58077;Pisoniano;1;0;1;Egitto;Africa Settentrionale;Africa
58077;Pisoniano;0;1;1;Gambia;Africa Occidentale;Africa
58077;Pisoniano;1;0;1;Ghana;Africa Occidentale;Africa
58077;Pisoniano;0;1;1;Haiti;America Centro-Meridionale;America
58077;Pisoniano;0;1;1;Iraq;Asia Occidentale;Asia
58077;Pisoniano;0;1;1;Marocco;Africa Settentrionale;Africa
58077;Pisoniano;1;0;1;Pakistan;Asia Centro-Meridionale;Asia
58077;Pisoniano;0;1;1;Regno Unito;Altri paesi europei;Europa
58077;Pisoniano;1;0;1;Sri Lanka (ex Ceylon);Asia Centro-Meridionale;Asia
58077;Pisoniano;0;1;1;Uganda;Africa Orientale;Africa
58077;Pisoniano;0;1;1;Zimbabwe (ex Rhodesia);Africa Orientale;Africa
58078;Poli;76;91;167;Romania;Unione Europea;Europa
58078;Poli;11;5;16;Albania;Europa Centro-Orientale;Europa
58078;Poli;4;9;13;Polonia;Unione Europea;Europa
58078;Poli;1;6;7;Ucraina;Europa Centro-Orientale;Europa
58078;Poli;3;2;5;Nigeria;Africa Occidentale;Africa
58078;Poli;2;3;5;Sri Lanka (ex Ceylon);Asia Centro-Meridionale;Asia
58078;Poli;3;1;4;Siria;Asia Occidentale;Asia
58078;Poli;1;2;3;Moldova;Europa Centro-Orientale;Europa
58078;Poli;0;2;2;Brasile;America Centro-Meridionale;America
58078;Poli;0;2;2;Cuba;America Centro-Meridionale;America
58078;Poli;2;0;2;Marocco;Africa Settentrionale;Africa
58078;Poli;1;1;2;Perù;America Centro-Meridionale;America
58078;Poli;0;1;1;Bielorussia;Europa Centro-Orientale;Europa
58078;Poli;1;0;1;Ecuador;America Centro-Meridionale;America
58078;Poli;1;0;1;Germania;Unione Europea;Europa
58078;Poli;1;0;1;Guinea;Africa Occidentale;Africa
58078;Poli;0;1;1;Slovacchia;Unione Europea;Europa
58078;Poli;1;0;1;Spagna;Unione Europea;Europa
58078;Poli;1;0;1;Turchia;Europa Centro-Orientale;Europa
58079;Pomezia;1864;1962;3826;Romania;Unione Europea;Europa
58079;Pomezia;148;255;403;Polonia;Unione Europea;Europa
58079;Pomezia;158;182;340;Moldova;Europa Centro-Orientale;Europa
58079;Pomezia;212;112;324;India;Asia Centro-Meridionale;Asia
58079;Pomezia;93;228;321;Ucraina;Europa Centro-Orientale;Europa
58079;Pomezia;167;152;319;Albania;Europa Centro-Orientale;Europa
58079;Pomezia;141;75;216;Marocco;Africa Settentrionale;Africa
58079;Pomezia;146;47;193;Egitto;Africa Settentrionale;Africa
58079;Pomezia;146;47;193;Pakistan;Asia Centro-Meridionale;Asia
58079;Pomezia;137;31;168;Bangladesh;Asia Centro-Meridionale;Asia
58079;Pomezia;82;67;149;Cinese, Repubblica Popolare;Asia Orientale;Asia
58079;Pomezia;64;70;134;Filippine;Asia Orientale;Asia
58079;Pomezia;76;52;128;Tunisia;Africa Settentrionale;Africa
58079;Pomezia;60;23;83;Senegal;Africa Occidentale;Africa
58079;Pomezia;62;16;78;Nigeria;Africa Occidentale;Africa
58079;Pomezia;37;36;73;Bulgaria;Unione Europea;Europa
58079;Pomezia;28;33;61;Perù;America Centro-Meridionale;America
58079;Pomezia;11;49;60;Russa, Federazione;Europa Centro-Orientale;Europa
58079;Pomezia;14;43;57;Brasile;America Centro-Meridionale;America
58079;Pomezia;37;19;56;Macedonia del Nord;Europa Centro-Orientale;Europa
58079;Pomezia;16;33;49;Colombia;America Centro-Meridionale;America
58079;Pomezia;25;20;45;Sri Lanka (ex Ceylon);Asia Centro-Meridionale;Asia
58079;Pomezia;35;6;41;Ghana;Africa Occidentale;Africa
58079;Pomezia;12;28;40;Spagna;Unione Europea;Europa
58079;Pomezia;18;18;36;Kosovo;Europa Centro-Orientale;Europa
58079;Pomezia;22;14;36;Turchia;Europa Centro-Orientale;Europa
58079;Pomezia;21;14;35;Montenegro;Europa Centro-Orientale;Europa
58079;Pomezia;12;20;32;Ecuador;America Centro-Meridionale;America
58079;Pomezia;9;20;29;Cuba;America Centro-Meridionale;America
58079;Pomezia;8;17;25;Georgia;Asia Occidentale;Asia
58079;Pomezia;12;13;25;Sierra Leone;Africa Occidentale;Africa
58079;Pomezia;6;18;24;Francia;Unione Europea;Europa
58079;Pomezia;10;14;24;Regno Unito;Altri paesi europei;Europa
58079;Pomezia;9;13;22;Argentina;America Centro-Meridionale;America
58079;Pomezia;12;8;20;Bosnia-Erzegovina;Europa Centro-Orientale;Europa
58079;Pomezia;19;0;19;Somalia;Africa Orientale;Africa
58079;Pomezia;5;13;18;Germania;Unione Europea;Europa
58079;Pomezia;10;7;17;Algeria;Africa Settentrionale;Africa
58079;Pomezia;12;5;17;Siria;Asia Occidentale;Asia
58079;Pomezia;11;5;16;Iran, Repubblica Islamica del;Asia Occidentale;Asia
58079;Pomezia;8;8;16;Stati Uniti d'America;America Settentrionale;America
58079;Pomezia;2;13;15;Bielorussia;Europa Centro-Orientale;Europa
58079;Pomezia;14;0;14;Gambia;Africa Occidentale;Africa
58079;Pomezia;7;6;13;Dominicana, Repubblica;America Centro-Meridionale;America
58079;Pomezia;6;6;12;Venezuela;America Centro-Meridionale;America
58079;Pomezia;10;1;11;Mali;Africa Occidentale;Africa
58079;Pomezia;8;2;10;Guinea;Africa Occidentale;Africa
58079;Pomezia;2;7;9;Benin (ex Dahomey);Africa Occidentale;Africa
58079;Pomezia;5;4;9;Capo Verde;Africa Occidentale;Africa
58079;Pomezia;2;7;9;Croazia;Unione Europea;Europa
58079;Pomezia;8;1;9;Iraq;Asia Occidentale;Asia
58079;Pomezia;6;3;9;Messico;America Centro-Meridionale;America
58079;Pomezia;5;4;9;Portogallo;Unione Europea;Europa
58079;Pomezia;2;7;9;Slovacchia;Unione Europea;Europa
58079;Pomezia;4;4;8;Giappone;Asia Orientale;Asia
58079;Pomezia;1;7;8;Thailandia;Asia Orientale;Asia
58079;Pomezia;1;7;8;Ungheria;Unione Europea;Europa
58079;Pomezia;6;1;7;Costa d'Avorio;Africa Occidentale;Africa
58079;Pomezia;6;1;7;Eritrea;Africa Orientale;Africa
58079;Pomezia;3;4;7;Etiopia;Africa Orientale;Africa
58079;Pomezia;4;3;7;Lituania;Unione Europea;Europa
58079;Pomezia;1;6;7;Serbia, Repubblica di;Europa Centro-Orientale;Europa
58079;Pomezia;5;0;5;Afghanistan;Asia Centro-Meridionale;Asia
58079;Pomezia;5;0;5;Camerun;Africa Centro-Meridionale;Africa
58079;Pomezia;1;4;5;Lettonia;Unione Europea;Europa
58079;Pomezia;3;2;5;Paesi Bassi;Unione Europea;Europa
58079;Pomezia;2;2;4;Apolide;;
58079;Pomezia;2;2;4;Austria;Unione Europea;Europa
58079;Pomezia;1;3;4;Belgio;Unione Europea;Europa
58079;Pomezia;0;4;4;Ceca, Repubblica;Unione Europea;Europa
58079;Pomezia;4;0;4;Sudan;Africa Settentrionale;Africa
58079;Pomezia;0;3;3;Angola;Africa Centro-Meridionale;Africa
58079;Pomezia;3;0;3;Burkina Faso (ex Alto Volta);Africa Occidentale;Africa
58079;Pomezia;0;3;3;Canada;America Settentrionale;America
58079;Pomezia;0;3;3;Cile;America Centro-Meridionale;America
58079;Pomezia;3;0;3;Congo, Repubblica democratica del (ex Zaire);Africa Centro-Meridionale;Africa
58079;Pomezia;1;2;3;Giordania;Asia Occidentale;Asia
58079;Pomezia;3;0;3;Guinea Bissau;Africa Occidentale;Africa
58079;Pomezia;1;2;3;Indonesia;Asia Orientale;Asia
58079;Pomezia;3;0;3;Libia;Africa Settentrionale;Africa
58079;Pomezia;1;2;3;Nepal;Asia Centro-Meridionale;Asia
58079;Pomezia;1;2;3;San Marino;Altri paesi europei;Europa
58079;Pomezia;1;1;2;Armenia;Asia Occidentale;Asia
58079;Pomezia;0;2;2;Bolivia;America Centro-Meridionale;America
58079;Pomezia;0;2;2;El Salvador;America Centro-Meridionale;America
58079;Pomezia;1;1;2;Gabon;Africa Centro-Meridionale;Africa
58079;Pomezia;1;1;2;Honduras;America Centro-Meridionale;America
58079;Pomezia;1;1;2;Irlanda;Unione Europea;Europa
58079;Pomezia;1;1;2;Libano;Asia Occidentale;Asia
58079;Pomezia;1;1;2;Madagascar;Africa Orientale;Africa
58079;Pomezia;2;0;2;Mauritania;Africa Occidentale;Africa
58079;Pomezia;0;2;2;Mauritius;Africa Orientale;Africa
58079;Pomezia;0;2;2;Paraguay;America Centro-Meridionale;America
58079;Pomezia;1;1;2;Svizzera;Altri paesi europei;Europa
58079;Pomezia;1;1;2;Uzbekistan;Asia Centro-Meridionale;Asia
58079;Pomezia;1;0;1;Arabia Saudita;Asia Occidentale;Asia
58079;Pomezia;1;0;1;Azerbaigian;Asia Occidentale;Asia
58079;Pomezia;0;1;1;Cambogia;Asia Orientale;Asia
58079;Pomezia;0;1;1;Cipro;Unione Europea;Europa
58079;Pomezia;1;0;1;Congo (Repubblica del);Africa Centro-Meridionale;Africa
58079;Pomezia;0;1;1;Corea, Repubblica (Corea del Sud);Asia Orientale;Asia
58079;Pomezia;0;1;1;Corea, Repubblica Popolare Democratica (Corea del Nord);Asia Orientale;Asia
58079;Pomezia;1;0;1;Danimarca;Unione Europea;Europa
58079;Pomezia;0;1;1;Finlandia;Unione Europea;Europa
58079;Pomezia;1;0;1;Grecia;Unione Europea;Europa
58079;Pomezia;0;1;1;Guatemala;America Centro-Meridionale;America
58079;Pomezia;0;1;1;Guinea Equatoriale;Africa Centro-Meridionale;Africa
58079;Pomezia;1;0;1;Israele;Asia Occidentale;Asia
58079;Pomezia;0;1;1;Kenya;Africa Orientale;Africa
58079;Pomezia;0;1;1;Kirghizistan;Asia Centro-Meridionale;Asia
58079;Pomezia;1;0;1;Malaysia;Asia Orientale;Asia
58079;Pomezia;1;0;1;Maldive;Asia Centro-Meridionale;Asia
58079;Pomezia;1;0;1;Niger;Africa Occidentale;Africa
58079;Pomezia;0;1;1;Norvegia;Altri paesi europei;Europa
58079;Pomezia;0;1;1;São Tomé e Principe;Africa Centro-Meridionale;Africa
58079;Pomezia;1;0;1;Svezia;Unione Europea;Europa
58079;Pomezia;1;0;1;Togo;Africa Occidentale;Africa
58079;Pomezia;1;0;1;Uganda;Africa Orientale;Africa
58079;Pomezia;1;0;1;Uruguay;America Centro-Meridionale;America
58079;Pomezia;1;0;1;Yemen;Asia Occidentale;Asia
58079;Pomezia;0;1;1;Zambia;Africa Orientale;Africa
58080;Ponzano Romano;46;56;102;Romania;Unione Europea;Europa
58080;Ponzano Romano;35;9;44;Pakistan;Asia Centro-Meridionale;Asia
58080;Ponzano Romano;9;8;17;Albania;Europa Centro-Orientale;Europa
58080;Ponzano Romano;8;7;15;Polonia;Unione Europea;Europa
58080;Ponzano Romano;4;6;10;Marocco;Africa Settentrionale;Africa
58080;Ponzano Romano;5;4;9;Kosovo;Europa Centro-Orientale;Europa
58080;Ponzano Romano;4;4;8;India;Asia Centro-Meridionale;Asia
58080;Ponzano Romano;3;3;6;Perù;America Centro-Meridionale;America
58080;Ponzano Romano;4;1;5;Argentina;America Centro-Meridionale;America
58080;Ponzano Romano;2;3;5;Bangladesh;Asia Centro-Meridionale;Asia
58080;Ponzano Romano;1;2;3;Mauritius;Africa Orientale;Africa
58080;Ponzano Romano;2;0;2;Camerun;Africa Centro-Meridionale;Africa
58080;Ponzano Romano;1;1;2;Ceca, Repubblica;Unione Europea;Europa
58080;Ponzano Romano;2;0;2;Cuba;America Centro-Meridionale;America
58080;Ponzano Romano;1;1;2;Messico;America Centro-Meridionale;America
58080;Ponzano Romano;0;1;1;Bielorussia;Europa Centro-Orientale;Europa
58080;Ponzano Romano;0;1;1;Brasile;America Centro-Meridionale;America
58080;Ponzano Romano;0;1;1;Canada;America Settentrionale;America
58080;Ponzano Romano;0;1;1;Congo, Repubblica democratica del (ex Zaire);Africa Centro-Meridionale;Africa
58080;Ponzano Romano;1;0;1;Egitto;Africa Settentrionale;Africa
58080;Ponzano Romano;0;1;1;Eritrea;Africa Orientale;Africa
58080;Ponzano Romano;0;1;1;Etiopia;Africa Orientale;Africa
58080;Ponzano Romano;1;0;1;Francia;Unione Europea;Europa
58080;Ponzano Romano;1;0;1;Gabon;Africa Centro-Meridionale;Africa
58080;Ponzano Romano;0;1;1;Georgia;Asia Occidentale;Asia
58080;Ponzano Romano;1;0;1;Grecia;Unione Europea;Europa
58080;Ponzano Romano;0;1;1;Macedonia del Nord;Europa Centro-Orientale;Europa
58080;Ponzano Romano;0;1;1;Paraguay;America Centro-Meridionale;America
58080;Ponzano Romano;0;1;1;Russa, Federazione;Europa Centro-Orientale;Europa
58080;Ponzano Romano;1;0;1;Sierra Leone;Africa Occidentale;Africa
58080;Ponzano Romano;0;1;1;Svizzera;Altri paesi europei;Europa
58080;Ponzano Romano;0;1;1;Ucraina;Europa Centro-Orientale;Europa
58081;Riano;526;540;1066;Romania;Unione Europea;Europa
58081;Riano;29;37;66;Polonia;Unione Europea;Europa
58081;Riano;15;31;46;Moldova;Europa Centro-Orientale;Europa
58081;Riano;20;21;41;Filippine;Asia Orientale;Asia
58081;Riano;20;19;39;Albania;Europa Centro-Orientale;Europa
58081;Riano;20;15;35;Macedonia del Nord;Europa Centro-Orientale;Europa
58081;Riano;20;10;30;India;Asia Centro-Meridionale;Asia
58081;Riano;16;11;27;Sri Lanka (ex Ceylon);Asia Centro-Meridionale;Asia
58081;Riano;18;8;26;Bangladesh;Asia Centro-Meridionale;Asia
58081;Riano;7;18;25;Ucraina;Europa Centro-Orientale;Europa
58081;Riano;13;11;24;Iran, Repubblica Islamica del;Asia Occidentale;Asia
58081;Riano;16;5;21;Egitto;Africa Settentrionale;Africa
58081;Riano;4;16;20;Cuba;America Centro-Meridionale;America
58081;Riano;9;8;17;Cinese, Repubblica Popolare;Asia Orientale;Asia
58081;Riano;7;9;16;Colombia;America Centro-Meridionale;America
58081;Riano;6;9;15;Ecuador;America Centro-Meridionale;America
58081;Riano;8;6;14;Tunisia;Africa Settentrionale;Africa
58081;Riano;4;8;12;Messico;America Centro-Meridionale;America
58081;Riano;3;8;11;Brasile;America Centro-Meridionale;America
58081;Riano;7;4;11;Francia;Unione Europea;Europa
58081;Riano;1;10;11;Regno Unito;Altri paesi europei;Europa
58081;Riano;6;4;10;Etiopia;Africa Orientale;Africa
58081;Riano;5;5;10;Kosovo;Europa Centro-Orientale;Europa
58081;Riano;3;7;10;Perù;America Centro-Meridionale;America
58081;Riano;5;5;10;Portogallo;Unione Europea;Europa
58081;Riano;5;4;9;Bulgaria;Unione Europea;Europa
58081;Riano;5;3;8;Eritrea;Africa Orientale;Africa
58081;Riano;4;3;7;Germania;Unione Europea;Europa
58081;Riano;3;4;7;Nigeria;Africa Occidentale;Africa
58081;Riano;3;4;7;Senegal;Africa Occidentale;Africa
58081;Riano;3;4;7;Spagna;Unione Europea;Europa
58081;Riano;2;4;6;Marocco;Africa Settentrionale;Africa
58081;Riano;0;6;6;Stati Uniti d'America;America Settentrionale;America
58081;Riano;3;2;5;Capo Verde;Africa Occidentale;Africa
58081;Riano;1;3;4;Iraq;Asia Occidentale;Asia
58081;Riano;4;0;4;Pakistan;Asia Centro-Meridionale;Asia
58081;Riano;0;4;4;Russa, Federazione;Europa Centro-Orientale;Europa
58081;Riano;1;3;4;Slovacchia;Unione Europea;Europa
58081;Riano;2;1;3;Camerun;Africa Centro-Meridionale;Africa
58081;Riano;2;1;3;Costa d'Avorio;Africa Occidentale;Africa
58081;Riano;0;3;3;Giappone;Asia Orientale;Asia
58081;Riano;0;3;3;Paesi Bassi;Unione Europea;Europa
58081;Riano;1;1;2;Armenia;Asia Occidentale;Asia
58081;Riano;0;2;2;Ceca, Repubblica;Unione Europea;Europa
58081;Riano;2;0;2;Centrafricana, Repubblica;Africa Centro-Meridionale;Africa
58081;Riano;1;1;2;Dominicana, Repubblica;America Centro-Meridionale;America
58081;Riano;0;2;2;Finlandia;Unione Europea;Europa
58081;Riano;0;2;2;Lituania;Unione Europea;Europa
58081;Riano;2;0;2;Paraguay;America Centro-Meridionale;America
58081;Riano;0;2;2;Svizzera;Altri paesi europei;Europa
58081;Riano;1;0;1;Afghanistan;Asia Centro-Meridionale;Asia
58081;Riano;1;0;1;Argentina;America Centro-Meridionale;America
58081;Riano;0;1;1;Austria;Unione Europea;Europa
58081;Riano;0;1;1;Belgio;Unione Europea;Europa
58081;Riano;0;1;1;Benin (ex Dahomey);Africa Occidentale;Africa
58081;Riano;0;1;1;Costa Rica;America Centro-Meridionale;America
58081;Riano;1;0;1;Gambia;Africa Occidentale;Africa
58081;Riano;0;1;1;Georgia;Asia Occidentale;Asia
58081;Riano;1;0;1;Giordania;Asia Occidentale;Asia
58081;Riano;0;1;1;Grecia;Unione Europea;Europa
58081;Riano;1;0;1;Guinea;Africa Occidentale;Africa
58081;Riano;0;1;1;Honduras;America Centro-Meridionale;America
58081;Riano;0;1;1;Lettonia;Unione Europea;Europa
58081;Riano;1;0;1;Libano;Asia Occidentale;Asia
58081;Riano;0;1;1;Malaysia;Asia Orientale;Asia
58081;Riano;0;1;1;Mali;Africa Occidentale;Africa
58081;Riano;0;1;1;Serbia, Repubblica di;Europa Centro-Orientale;Europa
58081;Riano;1;0;1;Somalia;Africa Orientale;Africa
58081;Riano;1;0;1;Sudan;Africa Settentrionale;Africa
58081;Riano;1;0;1;Territori dell'Autonomia Palestinese;Asia Occidentale;Asia
58081;Riano;0;1;1;Venezuela;America Centro-Meridionale;America
58082;Rignano Flaminio;555;573;1128;Romania;Unione Europea;Europa
58082;Rignano Flaminio;25;42;67;Moldova;Europa Centro-Orientale;Europa
58082;Rignano Flaminio;19;42;61;Filippine;Asia Orientale;Asia
58082;Rignano Flaminio;13;31;44;Ucraina;Europa Centro-Orientale;Europa
58082;Rignano Flaminio;39;2;41;Bangladesh;Asia Centro-Meridionale;Asia
58082;Rignano Flaminio;8;27;35;Polonia;Unione Europea;Europa
58082;Rignano Flaminio;10;22;32;Ecuador;America Centro-Meridionale;America
58082;Rignano Flaminio;10;17;27;Albania;Europa Centro-Orientale;Europa
58082;Rignano Flaminio;12;14;26;Cinese, Repubblica Popolare;Asia Orientale;Asia
58082;Rignano Flaminio;20;6;26;Egitto;Africa Settentrionale;Africa
58082;Rignano Flaminio;14;11;25;Sri Lanka (ex Ceylon);Asia Centro-Meridionale;Asia
58082;Rignano Flaminio;20;4;24;Senegal;Africa Occidentale;Africa
58082;Rignano Flaminio;11;12;23;Perù;America Centro-Meridionale;America
58082;Rignano Flaminio;11;7;18;Colombia;America Centro-Meridionale;America
58082;Rignano Flaminio;8;8;16;Marocco;Africa Settentrionale;Africa
58082;Rignano Flaminio;7;6;13;Macedonia del Nord;Europa Centro-Orientale;Europa
58082;Rignano Flaminio;8;5;13;Tunisia;Africa Settentrionale;Africa
58082;Rignano Flaminio;7;5;12;Iran, Repubblica Islamica del;Asia Occidentale;Asia
58082;Rignano Flaminio;3;8;11;Francia;Unione Europea;Europa
58082;Rignano Flaminio;7;4;11;India;Asia Centro-Meridionale;Asia
58082;Rignano Flaminio;5;3;8;Brasile;America Centro-Meridionale;America
58082;Rignano Flaminio;2;6;8;Capo Verde;Africa Occidentale;Africa
58082;Rignano Flaminio;3;4;7;Nigeria;Africa Occidentale;Africa
58082;Rignano Flaminio;2;4;6;Cuba;America Centro-Meridionale;America
58082;Rignano Flaminio;5;1;6;Libano;Asia Occidentale;Asia
58082;Rignano Flaminio;3;3;6;Tanzania;Africa Orientale;Africa
58082;Rignano Flaminio;1;4;5;Camerun;Africa Centro-Meridionale;Africa
58082;Rignano Flaminio;3;2;5;Danimarca;Unione Europea;Europa
58082;Rignano Flaminio;1;4;5;Germania;Unione Europea;Europa
58082;Rignano Flaminio;2;3;5;Stati Uniti d'America;America Settentrionale;America
58082;Rignano Flaminio;1;4;5;Ungheria;Unione Europea;Europa
58082;Rignano Flaminio;2;2;4;Afghanistan;Asia Centro-Meridionale;Asia
58082;Rignano Flaminio;1;3;4;Dominicana, Repubblica;America Centro-Meridionale;America
58082;Rignano Flaminio;0;4;4;Lettonia;Unione Europea;Europa
58082;Rignano Flaminio;1;3;4;Russa, Federazione;Europa Centro-Orientale;Europa
58082;Rignano Flaminio;2;2;4;Spagna;Unione Europea;Europa
58082;Rignano Flaminio;1;2;3;Bulgaria;Unione Europea;Europa
58082;Rignano Flaminio;0;3;3;Etiopia;Africa Orientale;Africa
58082;Rignano Flaminio;1;2;3;Giappone;Asia Orientale;Asia
58082;Rignano Flaminio;1;2;3;Kenya;Africa Orientale;Africa
58082;Rignano Flaminio;1;2;3;Paraguay;America Centro-Meridionale;America
58082;Rignano Flaminio;3;0;3;Somalia;Africa Orientale;Africa
58082;Rignano Flaminio;1;2;3;Venezuela;America Centro-Meridionale;America
58082;Rignano Flaminio;1;1;2;Ceca, Repubblica;Unione Europea;Europa
58082;Rignano Flaminio;1;1;2;Cile;America Centro-Meridionale;America
58082;Rignano Flaminio;1;1;2;Costa d'Avorio;Africa Occidentale;Africa
58082;Rignano Flaminio;0;2;2;Eritrea;Africa Orientale;Africa
58082;Rignano Flaminio;2;0;2;Gabon;Africa Centro-Meridionale;Africa
58082;Rignano Flaminio;2;0;2;Gambia;Africa Occidentale;Africa
58082;Rignano Flaminio;1;1;2;Lesotho;Africa Centro-Meridionale;Africa
58082;Rignano Flaminio;2;0;2;Lussemburgo;Unione Europea;Europa
58082;Rignano Flaminio;1;1;2;Madagascar;Africa Orientale;Africa
58082;Rignano Flaminio;2;0;2;Mali;Africa Occidentale;Africa
58082;Rignano Flaminio;0;2;2;Uganda;Africa Orientale;Africa
58082;Rignano Flaminio;0;1;1;Algeria;Africa Settentrionale;Africa
58082;Rignano Flaminio;0;1;1;Argentina;America Centro-Meridionale;America
58082;Rignano Flaminio;0;1;1;Austria;Unione Europea;Europa
58082;Rignano Flaminio;0;1;1;Belgio;Unione Europea;Europa
58082;Rignano Flaminio;0;1;1;Bielorussia;Europa Centro-Orientale;Europa
58082;Rignano Flaminio;1;0;1;Bolivia;America Centro-Meridionale;America
58082;Rignano Flaminio;0;1;1;Congo, Repubblica democratica del (ex Zaire);Africa Centro-Meridionale;Africa
58082;Rignano Flaminio;0;1;1;Corea, Repubblica (Corea del Sud);Asia Orientale;Asia
58082;Rignano Flaminio;0;1;1;Finlandia;Unione Europea;Europa
58082;Rignano Flaminio;1;0;1;Georgia;Asia Occidentale;Asia
58082;Rignano Flaminio;1;0;1;Grecia;Unione Europea;Europa
58082;Rignano Flaminio;0;1;1;Guatemala;America Centro-Meridionale;America
58082;Rignano Flaminio;0;1;1;Guinea;Africa Occidentale;Africa
58082;Rignano Flaminio;0;1;1;Indonesia;Asia Orientale;Asia
58082;Rignano Flaminio;1;0;1;Iraq;Asia Occidentale;Asia
58082;Rignano Flaminio;1;0;1;Irlanda;Unione Europea;Europa
58082;Rignano Flaminio;1;0;1;Mauritius;Africa Orientale;Africa
58082;Rignano Flaminio;1;0;1;Messico;America Centro-Meridionale;America
58082;Rignano Flaminio;1;0;1;Paesi Bassi;Unione Europea;Europa
58082;Rignano Flaminio;0;1;1;Pakistan;Asia Centro-Meridionale;Asia
58082;Rignano Flaminio;0;1;1;Portogallo;Unione Europea;Europa
58082;Rignano Flaminio;1;0;1;Regno Unito;Altri paesi europei;Europa
58082;Rignano Flaminio;0;1;1;Serbia, Repubblica di;Europa Centro-Orientale;Europa
58083;Riofreddo;36;41;77;Romania;Unione Europea;Europa
58083;Riofreddo;4;7;11;Polonia;Unione Europea;Europa
58083;Riofreddo;4;4;8;Albania;Europa Centro-Orientale;Europa
58083;Riofreddo;3;1;4;Algeria;Africa Settentrionale;Africa
58083;Riofreddo;1;1;2;Cinese, Repubblica Popolare;Asia Orientale;Asia
58083;Riofreddo;1;1;2;Ghana;Africa Occidentale;Africa
58083;Riofreddo;0;1;1;Colombia;America Centro-Meridionale;America
58083;Riofreddo;1;0;1;Gambia;Africa Occidentale;Africa
58083;Riofreddo;1;0;1;Senegal;Africa Occidentale;Africa
58083;Riofreddo;1;0;1;Sri Lanka (ex Ceylon);Asia Centro-Meridionale;Asia
58084;Rocca Canterano;0;1;1;Filippine;Asia Orientale;Asia
58084;Rocca Canterano;1;0;1;Polonia;Unione Europea;Europa
58084;Rocca Canterano;0;1;1;Ucraina;Europa Centro-Orientale;Europa
58084;Rocca Canterano;1;0;1;Venezuela;America Centro-Meridionale;America
58085;Rocca di Cave;1;3;4;Romania;Unione Europea;Europa
58085;Rocca di Cave;1;1;2;Germania;Unione Europea;Europa
58085;Rocca di Cave;0;1;1;Moldova;Europa Centro-Orientale;Europa
58085;Rocca di Cave;1;0;1;Nigeria;Africa Occidentale;Africa
58085;Rocca di Cave;0;1;1;Regno Unito;Altri paesi europei;Europa
58086;Rocca di Papa;415;422;837;Romania;Unione Europea;Europa
58086;Rocca di Papa;51;62;113;Moldova;Europa Centro-Orientale;Europa
58086;Rocca di Papa;56;44;100;Albania;Europa Centro-Orientale;Europa
58086;Rocca di Papa;72;11;83;Egitto;Africa Settentrionale;Africa
58086;Rocca di Papa;25;55;80;Polonia;Unione Europea;Europa
58086;Rocca di Papa;69;11;80;Somalia;Africa Orientale;Africa
58086;Rocca di Papa;44;32;76;Nigeria;Africa Occidentale;Africa
58086;Rocca di Papa;57;4;61;India;Asia Centro-Meridionale;Asia
58086;Rocca di Papa;14;42;56;Ucraina;Europa Centro-Orientale;Europa
58086;Rocca di Papa;29;23;52;Macedonia del Nord;Europa Centro-Orientale;Europa
58086;Rocca di Papa;43;3;46;Bangladesh;Asia Centro-Meridionale;Asia
58086;Rocca di Papa;23;15;38;Marocco;Africa Settentrionale;Africa
58086;Rocca di Papa;15;20;35;Spagna;Unione Europea;Europa
58086;Rocca di Papa;22;7;29;Pakistan;Asia Centro-Meridionale;Asia
58086;Rocca di Papa;4;23;27;Brasile;America Centro-Meridionale;America
58086;Rocca di Papa;23;0;23;Iraq;Asia Occidentale;Asia
58086;Rocca di Papa;11;10;21;Francia;Unione Europea;Europa
58086;Rocca di Papa;8;13;21;Perù;America Centro-Meridionale;America
58086;Rocca di Papa;16;5;21;Tunisia;Africa Settentrionale;Africa
58086;Rocca di Papa;7;11;18;Regno Unito;Altri paesi europei;Europa
58086;Rocca di Papa;10;6;16;Filippine;Asia Orientale;Asia
58086;Rocca di Papa;9;7;16;Iran, Repubblica Islamica del;Asia Occidentale;Asia
58086;Rocca di Papa;10;6;16;Libia;Africa Settentrionale;Africa
58086;Rocca di Papa;10;6;16;Siria;Asia Occidentale;Asia
58086;Rocca di Papa;11;2;13;Congo (Repubblica del);Africa Centro-Meridionale;Africa
58086;Rocca di Papa;6;6;12;Argentina;America Centro-Meridionale;America
58086;Rocca di Papa;6;6;12;Germania;Unione Europea;Europa
58086;Rocca di Papa;5;7;12;Portogallo;Unione Europea;Europa
58086;Rocca di Papa;6;4;10;Sri Lanka (ex Ceylon);Asia Centro-Meridionale;Asia
58086;Rocca di Papa;4;6;10;Stati Uniti d'America;America Settentrionale;America
58086;Rocca di Papa;9;0;9;Afghanistan;Asia Centro-Meridionale;Asia
58086;Rocca di Papa;9;0;9;Mali;Africa Occidentale;Africa
58086;Rocca di Papa;6;3;9;Svizzera;Altri paesi europei;Europa
58086;Rocca di Papa;5;3;8;Paesi Bassi;Unione Europea;Europa
58086;Rocca di Papa;2;5;7;Bulgaria;Unione Europea;Europa
58086;Rocca di Papa;5;1;6;Camerun;Africa Centro-Meridionale;Africa
58086;Rocca di Papa;3;3;6;Colombia;America Centro-Meridionale;America
58086;Rocca di Papa;6;0;6;Gambia;Africa Occidentale;Africa
58086;Rocca di Papa;2;4;6;Kenya;Africa Orientale;Africa
58086;Rocca di Papa;6;0;6;Sudan;Africa Settentrionale;Africa
58086;Rocca di Papa;5;1;6;Turchia;Europa Centro-Orientale;Europa
58086;Rocca di Papa;4;1;5;Ceca, Repubblica;Unione Europea;Europa
58086;Rocca di Papa;3;2;5;Cile;America Centro-Meridionale;America
58086;Rocca di Papa;5;0;5;Costa d'Avorio;Africa Occidentale;Africa
58086;Rocca di Papa;5;0;5;Ghana;Africa Occidentale;Africa
58086;Rocca di Papa;5;0;5;Territori dell'Autonomia Palestinese;Asia Occidentale;Asia
58086;Rocca di Papa;2;3;5;Venezuela;America Centro-Meridionale;America
58086;Rocca di Papa;1;3;4;Etiopia;Africa Orientale;Africa
58086;Rocca di Papa;3;1;4;Giordania;Asia Occidentale;Asia
58086;Rocca di Papa;1;3;4;Honduras;America Centro-Meridionale;America
58086;Rocca di Papa;0;4;4;Messico;America Centro-Meridionale;America
58086;Rocca di Papa;3;1;4;Senegal;Africa Occidentale;Africa
58086;Rocca di Papa;1;2;3;Bielorussia;Europa Centro-Orientale;Europa
58086;Rocca di Papa;1;2;3;Corea, Repubblica (Corea del Sud);Asia Orientale;Asia
58086;Rocca di Papa;1;2;3;Croazia;Unione Europea;Europa
58086;Rocca di Papa;1;2;3;Cuba;America Centro-Meridionale;America
58086;Rocca di Papa;0;3;3;Giappone;Asia Orientale;Asia
58086;Rocca di Papa;0;3;3;Indonesia;Asia Orientale;Asia
58086;Rocca di Papa;0;3;3;Irlanda;Unione Europea;Europa
58086;Rocca di Papa;2;1;3;Libano;Asia Occidentale;Asia
58086;Rocca di Papa;1;2;3;Malta;Unione Europea;Europa
58086;Rocca di Papa;0;3;3;Montenegro;Europa Centro-Orientale;Europa
58086;Rocca di Papa;3;0;3;Togo;Africa Occidentale;Africa
58086;Rocca di Papa;1;1;2;Algeria;Africa Settentrionale;Africa
58086;Rocca di Papa;1;1;2;Belgio;Unione Europea;Europa
58086;Rocca di Papa;1;1;2;Bolivia;America Centro-Meridionale;America
58086;Rocca di Papa;2;0;2;Burkina Faso (ex Alto Volta);Africa Occidentale;Africa
58086;Rocca di Papa;1;1;2;Burundi;Africa Orientale;Africa
58086;Rocca di Papa;0;2;2;El Salvador;America Centro-Meridionale;America
58086;Rocca di Papa;1;1;2;Lettonia;Unione Europea;Europa
58086;Rocca di Papa;1;1;2;Norvegia;Altri paesi europei;Europa
58086;Rocca di Papa;0;2;2;Russa, Federazione;Europa Centro-Orientale;Europa
58086;Rocca di Papa;0;2;2;Slovacchia;Unione Europea;Europa
58086;Rocca di Papa;0;2;2;Thailandia;Asia Orientale;Asia
58086;Rocca di Papa;1;1;2;Ungheria;Unione Europea;Europa
58086;Rocca di Papa;1;1;2;Zambia;Africa Orientale;Africa
58086;Rocca di Papa;0;2;2;Zimbabwe (ex Rhodesia);Africa Orientale;Africa
58086;Rocca di Papa;1;0;1;Azerbaigian;Asia Occidentale;Asia
58086;Rocca di Papa;0;1;1;Benin (ex Dahomey);Africa Occidentale;Africa
58086;Rocca di Papa;0;1;1;Bosnia-Erzegovina;Europa Centro-Orientale;Europa
58086;Rocca di Papa;1;0;1;Canada;America Settentrionale;America
58086;Rocca di Papa;0;1;1;Cinese, Repubblica Popolare;Asia Orientale;Asia
58086;Rocca di Papa;0;1;1;Congo, Repubblica democratica del (ex Zaire);Africa Centro-Meridionale;Africa
58086;Rocca di Papa;0;1;1;Costa Rica;America Centro-Meridionale;America
58086;Rocca di Papa;0;1;1;Danimarca;Unione Europea;Europa
58086;Rocca di Papa;0;1;1;Dominicana, Repubblica;America Centro-Meridionale;America
58086;Rocca di Papa;0;1;1;Ecuador;America Centro-Meridionale;America
58086;Rocca di Papa;1;0;1;Eritrea;Africa Orientale;Africa
58086;Rocca di Papa;0;1;1;Finlandia;Unione Europea;Europa
58086;Rocca di Papa;1;0;1;Gabon;Africa Centro-Meridionale;Africa
58086;Rocca di Papa;0;1;1;Georgia;Asia Occidentale;Asia
58086;Rocca di Papa;1;0;1;Kosovo;Europa Centro-Orientale;Europa
58086;Rocca di Papa;0;1;1;Lussemburgo;Unione Europea;Europa
58086;Rocca di Papa;1;0;1;Monaco;Altri paesi europei;Europa
58086;Rocca di Papa;0;1;1;Nicaragua;America Centro-Meridionale;America
58086;Rocca di Papa;1;0;1;Niger;Africa Occidentale;Africa
58086;Rocca di Papa;1;0;1;Paraguay;America Centro-Meridionale;America
58086;Rocca di Papa;0;1;1;Serbia, Repubblica di;Europa Centro-Orientale;Europa
58086;Rocca di Papa;0;1;1;Slovenia;Unione Europea;Europa
58086;Rocca di Papa;1;0;1;Sud Sudan, Repubblica del;Africa Settentrionale;Africa
58086;Rocca di Papa;1;0;1;Svezia;Unione Europea;Europa
58087;Roccagiovine;7;5;12;Romania;Unione Europea;Europa
58087;Roccagiovine;3;1;4;Sri Lanka (ex Ceylon);Asia Centro-Meridionale;Asia
58087;Roccagiovine;3;0;3;Tunisia;Africa Settentrionale;Africa
58087;Roccagiovine;2;1;3;Venezuela;America Centro-Meridionale;America
58087;Roccagiovine;1;1;2;Marocco;Africa Settentrionale;Africa
58087;Roccagiovine;0;2;2;Perù;America Centro-Meridionale;America
58087;Roccagiovine;0;2;2;Polonia;Unione Europea;Europa
58087;Roccagiovine;0;1;1;Nigeria;Africa Occidentale;Africa
58088;Rocca Priora;212;248;460;Romania;Unione Europea;Europa
58088;Rocca Priora;40;38;78;Albania;Europa Centro-Orientale;Europa
58088;Rocca Priora;35;22;57;Macedonia del Nord;Europa Centro-Orientale;Europa
58088;Rocca Priora;12;42;54;Ucraina;Europa Centro-Orientale;Europa
58088;Rocca Priora;12;38;50;Polonia;Unione Europea;Europa
58088;Rocca Priora;17;22;39;Moldova;Europa Centro-Orientale;Europa
58088;Rocca Priora;20;2;22;Bangladesh;Asia Centro-Meridionale;Asia
58088;Rocca Priora;15;6;21;Egitto;Africa Settentrionale;Africa
58088;Rocca Priora;13;6;19;Marocco;Africa Settentrionale;Africa
58088;Rocca Priora;7;9;16;Regno Unito;Altri paesi europei;Europa
58088;Rocca Priora;12;3;15;Nigeria;Africa Occidentale;Africa
58088;Rocca Priora;3;9;12;Brasile;America Centro-Meridionale;America
58088;Rocca Priora;0;12;12;Russa, Federazione;Europa Centro-Orientale;Europa
58088;Rocca Priora;4;5;9;Kosovo;Europa Centro-Orientale;Europa
58088;Rocca Priora;9;0;9;Pakistan;Asia Centro-Meridionale;Asia
58088;Rocca Priora;5;3;8;Cinese, Repubblica Popolare;Asia Orientale;Asia
58088;Rocca Priora;6;2;8;India;Asia Centro-Meridionale;Asia
58088;Rocca Priora;2;6;8;Stati Uniti d'America;America Settentrionale;America
58088;Rocca Priora;3;4;7;Cuba;America Centro-Meridionale;America
58088;Rocca Priora;1;6;7;Ecuador;America Centro-Meridionale;America
58088;Rocca Priora;3;3;6;Iran, Repubblica Islamica del;Asia Occidentale;Asia
58088;Rocca Priora;3;3;6;Sri Lanka (ex Ceylon);Asia Centro-Meridionale;Asia
58088;Rocca Priora;2;3;5;Bielorussia;Europa Centro-Orientale;Europa
58088;Rocca Priora;4;1;5;Camerun;Africa Centro-Meridionale;Africa
58088;Rocca Priora;1;4;5;Colombia;America Centro-Meridionale;America
58088;Rocca Priora;1;4;5;Spagna;Unione Europea;Europa
58088;Rocca Priora;2;2;4;Belgio;Unione Europea;Europa
58088;Rocca Priora;1;3;4;Filippine;Asia Orientale;Asia
58088;Rocca Priora;1;3;4;Francia;Unione Europea;Europa
58088;Rocca Priora;0;4;4;Georgia;Asia Occidentale;Asia
58088;Rocca Priora;0;4;4;Germania;Unione Europea;Europa
58088;Rocca Priora;1;3;4;Malta;Unione Europea;Europa
58088;Rocca Priora;0;4;4;Perù;America Centro-Meridionale;America
58088;Rocca Priora;2;1;3;Algeria;Africa Settentrionale;Africa
58088;Rocca Priora;1;2;3;Bulgaria;Unione Europea;Europa
58088;Rocca Priora;1;2;3;Costa d'Avorio;Africa Occidentale;Africa
58088;Rocca Priora;2;1;3;Mauritius;Africa Orientale;Africa
58088;Rocca Priora;1;2;3;Nicaragua;America Centro-Meridionale;America
58088;Rocca Priora;3;0;3;Togo;Africa Occidentale;Africa
58088;Rocca Priora;0;3;3;Venezuela;America Centro-Meridionale;America
58088;Rocca Priora;0;2;2;Argentina;America Centro-Meridionale;America
58088;Rocca Priora;0;2;2;Cile;America Centro-Meridionale;America
58088;Rocca Priora;1;1;2;Croazia;Unione Europea;Europa
58088;Rocca Priora;0;2;2;Dominicana, Repubblica;America Centro-Meridionale;America
58088;Rocca Priora;1;1;2;Giappone;Asia Orientale;Asia
58088;Rocca Priora;1;1;2;Grecia;Unione Europea;Europa
58088;Rocca Priora;1;1;2;Paesi Bassi;Unione Europea;Europa
58088;Rocca Priora;0;2;2;Serbia, Repubblica di;Europa Centro-Orientale;Europa
58088;Rocca Priora;0;2;2;Slovacchia;Unione Europea;Europa
58088;Rocca Priora;0;1;1;Austria;Unione Europea;Europa
58088;Rocca Priora;0;1;1;Bosnia-Erzegovina;Europa Centro-Orientale;Europa
58088;Rocca Priora;0;1;1;Capo Verde;Africa Occidentale;Africa
58088;Rocca Priora;1;0;1;Congo, Repubblica democratica del (ex Zaire);Africa Centro-Meridionale;Africa
58088;Rocca Priora;0;1;1;Finlandia;Unione Europea;Europa
58088;Rocca Priora;1;0;1;Gambia;Africa Occidentale;Africa
58088;Rocca Priora;0;1;1;Guinea;Africa Occidentale;Africa
58088;Rocca Priora;0;1;1;Irlanda;Unione Europea;Europa
58088;Rocca Priora;1;0;1;Kenya;Africa Orientale;Africa
58088;Rocca Priora;1;0;1;Lituania;Unione Europea;Europa
58088;Rocca Priora;1;0;1;Norvegia;Altri paesi europei;Europa
58088;Rocca Priora;1;0;1;Senegal;Africa Occidentale;Africa
58088;Rocca Priora;1;0;1;Singapore;Asia Orientale;Asia
58088;Rocca Priora;1;0;1;Sudan;Africa Settentrionale;Africa
58088;Rocca Priora;1;0;1;Territori dell'Autonomia Palestinese;Asia Occidentale;Asia
58088;Rocca Priora;1;0;1;Turchia;Europa Centro-Orientale;Europa
58089;Rocca Santo Stefano;27;34;61;Romania;Unione Europea;Europa
58089;Rocca Santo Stefano;6;5;11;Albania;Europa Centro-Orientale;Europa
58089;Rocca Santo Stefano;1;0;1;Cinese, Repubblica Popolare;Asia Orientale;Asia
58089;Rocca Santo Stefano;0;1;1;Georgia;Asia Occidentale;Asia
58089;Rocca Santo Stefano;0;1;1;Nigeria;Africa Occidentale;Africa
58089;Rocca Santo Stefano;0;1;1;Polonia;Unione Europea;Europa
58090;Roiate;0;5;5;Romania;Unione Europea;Europa
58090;Roiate;1;0;1;Angola;Africa Centro-Meridionale;Africa
58090;Roiate;1;0;1;Libia;Africa Settentrionale;Africa
58090;Roiate;0;1;1;Ucraina;Europa Centro-Orientale;Europa
58091;Roma;31735;43195;74930;Romania;Unione Europea;Europa
58091;Roma;16004;22480;38484;Filippine;Asia Orientale;Asia
58091;Roma;23861;9102;32963;Bangladesh;Asia Centro-Meridionale;Asia
58091;Roma;8746;8498;17244;Cinese, Repubblica Popolare;Asia Orientale;Asia
58091;Roma;2660;10873;13533;Ucraina;Europa Centro-Orientale;Europa
58091;Roma;4549;6795;11344;Perù;America Centro-Meridionale;America
58091;Roma;5629;5024;10653;India;Asia Centro-Meridionale;Asia
58091;Roma;7484;2875;10359;Egitto;Africa Settentrionale;Africa
58091;Roma;2799;5972;8771;Polonia;Unione Europea;Europa
58091;Roma;4561;4158;8719;Sri Lanka (ex Ceylon);Asia Centro-Meridionale;Asia
58091;Roma;3510;3348;6858;Albania;Europa Centro-Orientale;Europa
58091;Roma;2375;4364;6739;Moldova;Europa Centro-Orientale;Europa
58091;Roma;2467;3417;5884;Ecuador;America Centro-Meridionale;America
58091;Roma;2673;2146;4819;Nigeria;Africa Occidentale;Africa
58091;Roma;2674;2123;4797;Marocco;Africa Settentrionale;Africa
58091;Roma;1628;2526;4154;Spagna;Unione Europea;Europa
58091;Roma;1148;2345;3493;Brasile;America Centro-Meridionale;America
58091;Roma;1349;2085;3434;Francia;Unione Europea;Europa
58091;Roma;2011;543;2554;Pakistan;Asia Centro-Meridionale;Asia
58091;Roma;1874;535;2409;Senegal;Africa Occidentale;Africa
58091;Roma;1078;1246;2324;Regno Unito;Altri paesi europei;Europa
58091;Roma;1013;1220;2233;Colombia;America Centro-Meridionale;America
58091;Roma;1328;828;2156;Tunisia;Africa Settentrionale;Africa
58091;Roma;1086;1039;2125;Bosnia-Erzegovina;Europa Centro-Orientale;Europa
58091;Roma;1058;1047;2105;Iran, Repubblica Islamica del;Asia Occidentale;Asia
58091;Roma;379;1671;2050;Russa, Federazione;Europa Centro-Orientale;Europa
58091;Roma;898;1113;2011;Stati Uniti d'America;America Settentrionale;America
58091;Roma;725;1250;1975;Germania;Unione Europea;Europa
58091;Roma;1054;823;1877;Eritrea;Africa Orientale;Africa
58091;Roma;686;1088;1774;Etiopia;Africa Orientale;Africa
58091;Roma;437;1326;1763;Bulgaria;Unione Europea;Europa
58091;Roma;1511;42;1553;Mali;Africa Occidentale;Africa
58091;Roma;246;1271;1517;Georgia;Asia Occidentale;Asia
58091;Roma;1212;268;1480;Somalia;Africa Orientale;Africa
58091;Roma;439;862;1301;Cuba;America Centro-Meridionale;America
58091;Roma;1099;161;1260;Afghanistan;Asia Centro-Meridionale;Asia
58091;Roma;455;718;1173;El Salvador;America Centro-Meridionale;America
58091;Roma;440;720;1160;Dominicana, Repubblica;America Centro-Meridionale;America
58091;Roma;643;471;1114;Macedonia del Nord;Europa Centro-Orientale;Europa
58091;Roma;521;555;1076;Messico;America Centro-Meridionale;America
58091;Roma;337;727;1064;Capo Verde;Africa Occidentale;Africa
58091;Roma;747;147;894;Iraq;Asia Occidentale;Asia
58091;Roma;847;45;892;Gambia;Africa Occidentale;Africa
58091;Roma;213;661;874;Giappone;Asia Orientale;Asia
58091;Roma;453;401;854;Corea, Repubblica (Corea del Sud);Asia Orientale;Asia
58091;Roma;364;486;850;Venezuela;America Centro-Meridionale;America
58091;Roma;371;466;837;Portogallo;Unione Europea;Europa
58091;Roma;316;499;815;Bolivia;America Centro-Meridionale;America
58091;Roma;503;278;781;Siria;Asia Occidentale;Asia
58091;Roma;615;162;777;Costa d'Avorio;Africa Occidentale;Africa
58091;Roma;351;407;758;Argentina;America Centro-Meridionale;America
58091;Roma;472;282;754;Turchia;Europa Centro-Orientale;Europa
58091;Roma;328;387;715;Croazia;Unione Europea;Europa
58091;Roma;460;239;699;Libia;Africa Settentrionale;Africa
58091;Roma;529;155;684;Guinea;Africa Occidentale;Africa
58091;Roma;284;382;666;Serbia, Repubblica di;Europa Centro-Orientale;Europa
58091;Roma;355;291;646;Kosovo;Europa Centro-Orientale;Europa
58091;Roma;395;246;641;Algeria;Africa Settentrionale;Africa
58091;Roma;357;270;627;Camerun;Africa Centro-Meridionale;Africa
58091;Roma;318;303;621;Congo, Repubblica democratica del (ex Zaire);Africa Centro-Meridionale;Africa
58091;Roma;165;433;598;Indonesia;Asia Orientale;Asia
58091;Roma;295;294;589;Grecia;Unione Europea;Europa
58091;Roma;147;436;583;Bielorussia;Europa Centro-Orientale;Europa
58091;Roma;170;383;553;Honduras;America Centro-Meridionale;America
58091;Roma;219;314;533;Paesi Bassi;Unione Europea;Europa
58091;Roma;281;249;530;Irlanda;Unione Europea;Europa
58091;Roma;171;311;482;Kenya;Africa Orientale;Africa
58091;Roma;353;124;477;Ghana;Africa Occidentale;Africa
58091;Roma;230;245;475;Belgio;Unione Europea;Europa
58091;Roma;130;322;452;Austria;Unione Europea;Europa
58091;Roma;133;284;417;Madagascar;Africa Orientale;Africa
58091;Roma;265;139;404;Libano;Asia Occidentale;Asia
58091;Roma;115;258;373;Ungheria;Unione Europea;Europa
58091;Roma;158;213;371;Vietnam;Asia Orientale;Asia
58091;Roma;287;61;348;Sudan;Africa Settentrionale;Africa
58091;Roma;146;195;341;Svizzera;Altri paesi europei;Europa
58091;Roma;48;290;338;Thailandia;Asia Orientale;Asia
58091;Roma;206;129;335;Nepal;Asia Centro-Meridionale;Asia
58091;Roma;164;165;329;Cile;America Centro-Meridionale;America
58091;Roma;96;222;318;Svezia;Unione Europea;Europa
58091;Roma;181;127;308;Burkina Faso (ex Alto Volta);Africa Occidentale;Africa
58091;Roma;89;210;299;Slovacchia;Unione Europea;Europa
58091;Roma;137;161;298;Canada;America Settentrionale;America
58091;Roma;72;211;283;Paraguay;America Centro-Meridionale;America
58091;Roma;121;129;250;Congo (Repubblica del);Africa Centro-Meridionale;Africa
58091;Roma;112;138;250;Montenegro;Europa Centro-Orientale;Europa
58091;Roma;65;175;240;Lituania;Unione Europea;Europa
58091;Roma;156;76;232;Togo;Africa Occidentale;Africa
58091;Roma;81;149;230;Nicaragua;America Centro-Meridionale;America
58091;Roma;71;158;229;Guatemala;America Centro-Meridionale;America
58091;Roma;44;181;225;Ceca, Repubblica;Unione Europea;Europa
58091;Roma;117;95;212;Israele;Asia Occidentale;Asia
58091;Roma;69;136;205;Finlandia;Unione Europea;Europa
58091;Roma;104;91;195;Tanzania;Africa Orientale;Africa
58091;Roma;114;74;188;Sierra Leone;Africa Occidentale;Africa
58091;Roma;118;69;187;Azerbaigian;Asia Occidentale;Asia
58091;Roma;101;83;184;Angola;Africa Centro-Meridionale;Africa
58091;Roma;79;92;171;Australia;Oceania;Oceania
58091;Roma;45;124;169;Danimarca;Unione Europea;Europa
58091;Roma;97;69;166;Benin (ex Dahomey);Africa Occidentale;Africa
58091;Roma;72;94;166;Malta;Unione Europea;Europa
58091;Roma;104;47;151;Giordania;Asia Occidentale;Asia
58091;Roma;114;28;142;Territori dell'Autonomia Palestinese;Asia Occidentale;Asia
58091;Roma;67;69;136;Ruanda;Africa Orientale;Africa
58091;Roma;52;82;134;Mauritius;Africa Orientale;Africa
58091;Roma;79;55;134;Uganda;Africa Orientale;Africa
58091;Roma;44;87;131;Armenia;Asia Occidentale;Asia
58091;Roma;107;20;127;Mauritania;Africa Occidentale;Africa
58091;Roma;67;49;116;Apolide;;
58091;Roma;40;69;109;Myanmar (ex Birmania);Asia Orientale;Asia
58091;Roma;47;61;108;Slovenia;Unione Europea;Europa
58091;Roma;17;86;103;Kazakhstan;Asia Centro-Meridionale;Asia
58091;Roma;55;46;101;Burundi;Africa Orientale;Africa
58091;Roma;18;82;100;Lettonia;Unione Europea;Europa
58091;Roma;31;58;89;Norvegia;Altri paesi europei;Europa
58091;Roma;18;66;84;Kirghizistan;Asia Centro-Meridionale;Asia
58091;Roma;35;47;82;Uruguay;America Centro-Meridionale;America
58091;Roma;41;40;81;Haiti;America Centro-Meridionale;America
58091;Roma;36;45;81;Mozambico;Africa Orientale;Africa
58091;Roma;71;8;79;Guinea Bissau;Africa Occidentale;Africa
58091;Roma;47;31;78;San Marino;Altri paesi europei;Europa
58091;Roma;46;32;78;Zambia;Africa Orientale;Africa
58091;Roma;17;50;67;Costa Rica;America Centro-Meridionale;America
58091;Roma;54;9;63;Niger;Africa Occidentale;Africa
58091;Roma;21;35;56;Zimbabwe (ex Rhodesia);Africa Orientale;Africa
58091;Roma;27;26;53;Malaysia;Asia Orientale;Asia
58091;Roma;27;24;51;Gabon;Africa Centro-Meridionale;Africa
58091;Roma;21;25;46;Yemen;Asia Occidentale;Asia
58091;Roma;10;35;45;Estonia;Unione Europea;Europa
58091;Roma;12;33;45;Uzbekistan;Asia Centro-Meridionale;Asia
58091;Roma;32;11;43;Liberia;Africa Occidentale;Africa
58091;Roma;17;26;43;Nuova Zelanda;Oceania;Oceania
58091;Roma;21;20;41;Sud Africa;Africa Centro-Meridionale;Africa
58091;Roma;31;9;40;Sud Sudan, Repubblica del;Africa Settentrionale;Africa
58091;Roma;23;15;38;Kuwait;Asia Occidentale;Asia
58091;Roma;22;11;33;Arabia Saudita;Asia Occidentale;Asia
58091;Roma;22;11;33;Ciad;Africa Centro-Meridionale;Africa
58091;Roma;18;14;32;Centrafricana, Repubblica;Africa Centro-Meridionale;Africa
58091;Roma;9;22;31;Seychelles;Africa Orientale;Africa
58091;Roma;14;16;30;Guinea Equatoriale;Africa Centro-Meridionale;Africa
58091;Roma;9;20;29;Singapore;Asia Orientale;Asia
58091;Roma;9;18;27;Panama;America Centro-Meridionale;America
58091;Roma;6;21;27;Taiwan (ex Formosa);Asia Orientale;Asia
58091;Roma;12;14;26;Cipro;Unione Europea;Europa
58091;Roma;9;11;20;Malawi;Africa Orientale;Africa
58091;Roma;3;15;18;Mongolia;Asia Orientale;Asia
58091;Roma;7;10;17;Lussemburgo;Unione Europea;Europa
58091;Roma;6;11;17;Timor Orientale;Asia Orientale;Asia
58091;Roma;4;10;14;Dominica;America Centro-Meridionale;America
58091;Roma;7;7;14;Tagikistan;Asia Centro-Meridionale;Asia
58091;Roma;6;7;13;Islanda;Altri paesi europei;Europa
58091;Roma;3;9;12;Corea, Repubblica Popolare Democratica (Corea del Nord);Asia Orientale;Asia
58091;Roma;3;9;12;Samoa;Oceania;Oceania
58091;Roma;4;5;9;Trinidad e Tobago;America Centro-Meridionale;America
58091;Roma;4;4;8;Giamaica;America Centro-Meridionale;America
58091;Roma;3;5;8;Papua Nuova Guinea;Oceania;Oceania
58091;Roma;7;1;8;Stato della Città del Vaticano;Altri paesi europei;Europa
58091;Roma;1;6;7;Turkmenistan;Asia Centro-Meridionale;Asia
58091;Roma;6;0;6;Emirati Arabi Uniti;Asia Occidentale;Asia
58091;Roma;3;3;6;Figi;Oceania;Oceania
58091;Roma;0;6;6;Laos;Asia Orientale;Asia
58091;Roma;1;5;6;São Tomé e Principe;Africa Centro-Meridionale;Africa
58091;Roma;3;2;5;Barbados;America Centro-Meridionale;America
58091;Roma;3;2;5;Botswana;Africa Centro-Meridionale;Africa
58091;Roma;3;2;5;Qatar;Asia Occidentale;Asia
58091;Roma;2;2;4;Bahrein;Asia Occidentale;Asia
58091;Roma;1;3;4;Cambogia;Asia Orientale;Asia
58091;Roma;1;3;4;Oman;Asia Occidentale;Asia
58091;Roma;1;2;3;Antigua e Barbuda;America Centro-Meridionale;America
58091;Roma;2;1;3;Lesotho;Africa Centro-Meridionale;Africa
58091;Roma;1;2;3;Namibia;Africa Centro-Meridionale;Africa
58091;Roma;0;3;3;Vanuatu;Oceania;Oceania
58091;Roma;1;1;2;Andorra;Altri paesi europei;Europa
58091;Roma;1;1;2;Bahamas;America Centro-Meridionale;America
58091;Roma;2;0;2;Bhutan;Asia Centro-Meridionale;Asia
58091;Roma;1;1;2;Gibuti;Africa Orientale;Africa
58091;Roma;1;1;2;Monaco;Altri paesi europei;Europa
58091;Roma;0;2;2;Saint Lucia;America Centro-Meridionale;America
58091;Roma;0;1;1;Grenada;America Centro-Meridionale;America
58091;Roma;1;0;1;Kiribati;Oceania;Oceania
58091;Roma;0;1;1;Tonga;Oceania;Oceania
58092;Roviano;30;39;69;Romania;Unione Europea;Europa
58092;Roviano;4;7;11;Nigeria;Africa Occidentale;Africa
58092;Roviano;1;3;4;Costa d'Avorio;Africa Occidentale;Africa
58092;Roviano;2;2;4;Macedonia del Nord;Europa Centro-Orientale;Europa
58092;Roviano;2;2;4;Marocco;Africa Settentrionale;Africa
58092;Roviano;2;1;3;Albania;Europa Centro-Orientale;Europa
58092;Roviano;1;2;3;Bangladesh;Asia Centro-Meridionale;Asia
58092;Roviano;0;3;3;Moldova;Europa Centro-Orientale;Europa
58092;Roviano;2;1;3;Perù;America Centro-Meridionale;America
58092;Roviano;0;3;3;Polonia;Unione Europea;Europa
58092;Roviano;0;3;3;Russa, Federazione;Europa Centro-Orientale;Europa
58092;Roviano;1;1;2;Brasile;America Centro-Meridionale;America
58092;Roviano;1;1;2;Germania;Unione Europea;Europa
58092;Roviano;0;1;1;Argentina;America Centro-Meridionale;America
58092;Roviano;1;0;1;Congo, Repubblica democratica del (ex Zaire);Africa Centro-Meridionale;Africa
58092;Roviano;0;1;1;Croazia;Unione Europea;Europa
58092;Roviano;0;1;1;Cuba;America Centro-Meridionale;America
58092;Roviano;0;1;1;Iran, Repubblica Islamica del;Asia Occidentale;Asia
58092;Roviano;1;0;1;Iraq;Asia Occidentale;Asia
58092;Roviano;0;1;1;Irlanda;Unione Europea;Europa
58092;Roviano;0;1;1;Messico;America Centro-Meridionale;America
58092;Roviano;0;1;1;Senegal;Africa Occidentale;Africa
58092;Roviano;0;1;1;Venezuela;America Centro-Meridionale;America
58093;Sacrofano;375;328;703;Romania;Unione Europea;Europa
58093;Sacrofano;43;41;84;Polonia;Unione Europea;Europa
58093;Sacrofano;17;18;35;Filippine;Asia Orientale;Asia
58093;Sacrofano;13;15;28;Sri Lanka (ex Ceylon);Asia Centro-Meridionale;Asia
58093;Sacrofano;13;14;27;Perù;America Centro-Meridionale;America
58093;Sacrofano;14;9;23;India;Asia Centro-Meridionale;Asia
58093;Sacrofano;5;9;14;Regno Unito;Altri paesi europei;Europa
58093;Sacrofano;5;8;13;Bulgaria;Unione Europea;Europa
58093;Sacrofano;6;7;13;Francia;Unione Europea;Europa
58093;Sacrofano;5;7;12;Germania;Unione Europea;Europa
58093;Sacrofano;8;4;12;Macedonia del Nord;Europa Centro-Orientale;Europa
58093;Sacrofano;2;7;9;Moldova;Europa Centro-Orientale;Europa
58093;Sacrofano;3;5;8;Stati Uniti d'America;America Settentrionale;America
58093;Sacrofano;0;7;7;Russa, Federazione;Europa Centro-Orientale;Europa
58093;Sacrofano;0;7;7;Ucraina;Europa Centro-Orientale;Europa
58093;Sacrofano;2;4;6;Albania;Europa Centro-Orientale;Europa
58093;Sacrofano;5;1;6;Bangladesh;Asia Centro-Meridionale;Asia
58093;Sacrofano;4;2;6;Egitto;Africa Settentrionale;Africa
58093;Sacrofano;4;2;6;Portogallo;Unione Europea;Europa
58093;Sacrofano;3;2;5;Cinese, Repubblica Popolare;Asia Orientale;Asia
58093;Sacrofano;2;3;5;Ecuador;America Centro-Meridionale;America
58093;Sacrofano;1;3;4;Brasile;America Centro-Meridionale;America
58093;Sacrofano;2;2;4;Ghana;Africa Occidentale;Africa
58093;Sacrofano;1;3;4;Spagna;Unione Europea;Europa
58093;Sacrofano;0;3;3;Canada;America Settentrionale;America
58093;Sacrofano;1;2;3;Colombia;America Centro-Meridionale;America
58093;Sacrofano;2;1;3;Congo (Repubblica del);Africa Centro-Meridionale;Africa
58093;Sacrofano;2;1;3;Iran, Repubblica Islamica del;Asia Occidentale;Asia
58093;Sacrofano;3;0;3;Iraq;Asia Occidentale;Asia
58093;Sacrofano;0;3;3;Serbia, Repubblica di;Europa Centro-Orientale;Europa
58093;Sacrofano;2;1;3;Venezuela;America Centro-Meridionale;America
58093;Sacrofano;1;1;2;Bielorussia;Europa Centro-Orientale;Europa
58093;Sacrofano;1;1;2;Capo Verde;Africa Occidentale;Africa
58093;Sacrofano;0;2;2;Finlandia;Unione Europea;Europa
58093;Sacrofano;0;2;2;Giappone;Asia Orientale;Asia
58093;Sacrofano;0;2;2;Messico;America Centro-Meridionale;America
58093;Sacrofano;1;1;2;Siria;Asia Occidentale;Asia
58093;Sacrofano;0;2;2;Slovacchia;Unione Europea;Europa
58093;Sacrofano;0;2;2;Svezia;Unione Europea;Europa
58093;Sacrofano;0;2;2;Ungheria;Unione Europea;Europa
58093;Sacrofano;1;1;2;Zimbabwe (ex Rhodesia);Africa Orientale;Africa
58093;Sacrofano;1;0;1;Argentina;America Centro-Meridionale;America
58093;Sacrofano;1;0;1;Austria;Unione Europea;Europa
58093;Sacrofano;0;1;1;Corea, Repubblica (Corea del Sud);Asia Orientale;Asia
58093;Sacrofano;0;1;1;Costa d'Avorio;Africa Occidentale;Africa
58093;Sacrofano;0;1;1;Croazia;Unione Europea;Europa
58093;Sacrofano;0;1;1;Dominicana, Repubblica;America Centro-Meridionale;America
58093;Sacrofano;0;1;1;Eritrea;Africa Orientale;Africa
58093;Sacrofano;0;1;1;Honduras;America Centro-Meridionale;America
58093;Sacrofano;1;0;1;Lituania;Unione Europea;Europa
58093;Sacrofano;0;1;1;Marocco;Africa Settentrionale;Africa
58093;Sacrofano;0;1;1;Norvegia;Altri paesi europei;Europa
58093;Sacrofano;0;1;1;Paesi Bassi;Unione Europea;Europa
58093;Sacrofano;1;0;1;Pakistan;Asia Centro-Meridionale;Asia
58093;Sacrofano;0;1;1;San Marino;Altri paesi europei;Europa
58093;Sacrofano;1;0;1;Sierra Leone;Africa Occidentale;Africa
58093;Sacrofano;1;0;1;Tunisia;Africa Settentrionale;Africa
58094;Sambuci;25;30;55;Romania;Unione Europea;Europa
58094;Sambuci;2;5;7;Moldova;Europa Centro-Orientale;Europa
58094;Sambuci;0;4;4;Ucraina;Europa Centro-Orientale;Europa
58094;Sambuci;1;2;3;Polonia;Unione Europea;Europa
58094;Sambuci;0;1;1;Cuba;America Centro-Meridionale;America
58094;Sambuci;0;1;1;Russa, Federazione;Europa Centro-Orientale;Europa
58094;Sambuci;0;1;1;Venezuela;America Centro-Meridionale;America
58119;San Cesareo;810;768;1578;Romania;Unione Europea;Europa
58119;San Cesareo;57;27;84;Nigeria;Africa Occidentale;Africa
58119;San Cesareo;55;5;60;Bangladesh;Asia Centro-Meridionale;Asia
58119;San Cesareo;31;25;56;Albania;Europa Centro-Orientale;Europa
58119;San Cesareo;44;11;55;Egitto;Africa Settentrionale;Africa
58119;San Cesareo;24;11;35;Marocco;Africa Settentrionale;Africa
58119;San Cesareo;15;20;35;Moldova;Europa Centro-Orientale;Europa
58119;San Cesareo;19;12;31;Sri Lanka (ex Ceylon);Asia Centro-Meridionale;Asia
58119;San Cesareo;12;17;29;Cinese, Repubblica Popolare;Asia Orientale;Asia
58119;San Cesareo;10;19;29;Ucraina;Europa Centro-Orientale;Europa
58119;San Cesareo;5;19;24;Polonia;Unione Europea;Europa
58119;San Cesareo;15;8;23;Macedonia del Nord;Europa Centro-Orientale;Europa
58119;San Cesareo;16;6;22;India;Asia Centro-Meridionale;Asia
58119;San Cesareo;9;7;16;Pakistan;Asia Centro-Meridionale;Asia
58119;San Cesareo;13;1;14;Iraq;Asia Occidentale;Asia
58119;San Cesareo;7;6;13;Kosovo;Europa Centro-Orientale;Europa
58119;San Cesareo;4;8;12;Ecuador;America Centro-Meridionale;America
58119;San Cesareo;5;6;11;Perù;America Centro-Meridionale;America
58119;San Cesareo;5;4;9;Tunisia;Africa Settentrionale;Africa
58119;San Cesareo;3;4;7;Eritrea;Africa Orientale;Africa
58119;San Cesareo;2;5;7;Filippine;Asia Orientale;Asia
58119;San Cesareo;4;3;7;Francia;Unione Europea;Europa
58119;San Cesareo;2;5;7;Serbia, Repubblica di;Europa Centro-Orientale;Europa
58119;San Cesareo;2;3;5;Brasile;America Centro-Meridionale;America
58119;San Cesareo;2;3;5;Regno Unito;Altri paesi europei;Europa
58119;San Cesareo;2;2;4;Algeria;Africa Settentrionale;Africa
58119;San Cesareo;2;2;4;Bosnia-Erzegovina;Europa Centro-Orientale;Europa
58119;San Cesareo;2;2;4;Congo, Repubblica democratica del (ex Zaire);Africa Centro-Meridionale;Africa
58119;San Cesareo;1;3;4;Cuba;America Centro-Meridionale;America
58119;San Cesareo;0;4;4;Russa, Federazione;Europa Centro-Orientale;Europa
58119;San Cesareo;4;0;4;Senegal;Africa Occidentale;Africa
58119;San Cesareo;1;3;4;Venezuela;America Centro-Meridionale;America
58119;San Cesareo;1;2;3;Bulgaria;Unione Europea;Europa
58119;San Cesareo;1;1;2;Belgio;Unione Europea;Europa
58119;San Cesareo;1;1;2;Ceca, Repubblica;Unione Europea;Europa
58119;San Cesareo;0;2;2;Colombia;America Centro-Meridionale;America
58119;San Cesareo;2;0;2;Croazia;Unione Europea;Europa
58119;San Cesareo;2;0;2;Gambia;Africa Occidentale;Africa
58119;San Cesareo;1;1;2;Ghana;Africa Occidentale;Africa
58119;San Cesareo;0;2;2;Giappone;Asia Orientale;Asia
58119;San Cesareo;0;2;2;Paesi Bassi;Unione Europea;Europa
58119;San Cesareo;0;1;1;Apolide;;
58119;San Cesareo;0;1;1;Argentina;America Centro-Meridionale;America
58119;San Cesareo;1;0;1;Armenia;Asia Occidentale;Asia
58119;San Cesareo;0;1;1;Austria;Unione Europea;Europa
58119;San Cesareo;1;0;1;Bielorussia;Europa Centro-Orientale;Europa
58119;San Cesareo;0;1;1;Canada;America Settentrionale;America
58119;San Cesareo;1;0;1;Congo (Repubblica del);Africa Centro-Meridionale;Africa
58119;San Cesareo;0;1;1;Dominicana, Repubblica;America Centro-Meridionale;America
58119;San Cesareo;1;0;1;El Salvador;America Centro-Meridionale;America
58119;San Cesareo;0;1;1;Etiopia;Africa Orientale;Africa
58119;San Cesareo;0;1;1;Finlandia;Unione Europea;Europa
58119;San Cesareo;0;1;1;Georgia;Asia Occidentale;Asia
58119;San Cesareo;0;1;1;Germania;Unione Europea;Europa
58119;San Cesareo;0;1;1;Grecia;Unione Europea;Europa
58119;San Cesareo;1;0;1;Guatemala;America Centro-Meridionale;America
58119;San Cesareo;1;0;1;Honduras;America Centro-Meridionale;America
58119;San Cesareo;0;1;1;Kenya;Africa Orientale;Africa
58119;San Cesareo;0;1;1;Kirghizistan;Asia Centro-Meridionale;Asia
58119;San Cesareo;0;1;1;Madagascar;Africa Orientale;Africa
58119;San Cesareo;0;1;1;Messico;America Centro-Meridionale;America
58119;San Cesareo;1;0;1;Montenegro;Europa Centro-Orientale;Europa
58119;San Cesareo;0;1;1;Niger;Africa Occidentale;Africa
58119;San Cesareo;1;0;1;Portogallo;Unione Europea;Europa
58119;San Cesareo;1;0;1;Sierra Leone;Africa Occidentale;Africa
58119;San Cesareo;1;0;1;Siria;Asia Occidentale;Asia
58119;San Cesareo;0;1;1;Slovacchia;Unione Europea;Europa
58119;San Cesareo;1;0;1;Stati Uniti d'America;America Settentrionale;America
58119;San Cesareo;0;1;1;Svezia;Unione Europea;Europa
58119;San Cesareo;1;0;1;Turchia;Europa Centro-Orientale;Europa
58119;San Cesareo;0;1;1;Uruguay;America Centro-Meridionale;America
58095;San Gregorio da Sassola;12;22;34;Romania;Unione Europea;Europa
58095;San Gregorio da Sassola;6;6;12;Albania;Europa Centro-Orientale;Europa
58095;San Gregorio da Sassola;4;1;5;Egitto;Africa Settentrionale;Africa
58095;San Gregorio da Sassola;1;4;5;Moldova;Europa Centro-Orientale;Europa
58095;San Gregorio da Sassola;1;2;3;Iran, Repubblica Islamica del;Asia Occidentale;Asia
58095;San Gregorio da Sassola;0;3;3;Venezuela;America Centro-Meridionale;America
58095;San Gregorio da Sassola;1;1;2;Cuba;America Centro-Meridionale;America
58095;San Gregorio da Sassola;1;1;2;India;Asia Centro-Meridionale;Asia
58095;San Gregorio da Sassola;1;1;2;Ucraina;Europa Centro-Orientale;Europa
58095;San Gregorio da Sassola;1;0;1;Bangladesh;Asia Centro-Meridionale;Asia
58095;San Gregorio da Sassola;1;0;1;Brasile;America Centro-Meridionale;America
58095;San Gregorio da Sassola;0;1;1;Bulgaria;Unione Europea;Europa
58095;San Gregorio da Sassola;1;0;1;Filippine;Asia Orientale;Asia
58095;San Gregorio da Sassola;1;0;1;Germania;Unione Europea;Europa
58095;San Gregorio da Sassola;0;1;1;Polonia;Unione Europea;Europa
58096;San Polo dei Cavalieri;111;112;223;Romania;Unione Europea;Europa
58096;San Polo dei Cavalieri;5;7;12;Marocco;Africa Settentrionale;Africa
58096;San Polo dei Cavalieri;7;5;12;Nigeria;Africa Occidentale;Africa
58096;San Polo dei Cavalieri;1;5;6;Cuba;America Centro-Meridionale;America
58096;San Polo dei Cavalieri;3;3;6;Egitto;Africa Settentrionale;Africa
58096;San Polo dei Cavalieri;3;2;5;Albania;Europa Centro-Orientale;Europa
58096;San Polo dei Cavalieri;2;3;5;Colombia;America Centro-Meridionale;America
58096;San Polo dei Cavalieri;3;2;5;Perù;America Centro-Meridionale;America
58096;San Polo dei Cavalieri;3;1;4;Ecuador;America Centro-Meridionale;America
58096;San Polo dei Cavalieri;3;0;3;Bangladesh;Asia Centro-Meridionale;Asia
58096;San Polo dei Cavalieri;1;2;3;Croazia;Unione Europea;Europa
58096;San Polo dei Cavalieri;1;2;3;Grecia;Unione Europea;Europa
58096;San Polo dei Cavalieri;1;2;3;Macedonia del Nord;Europa Centro-Orientale;Europa
58096;San Polo dei Cavalieri;0;3;3;Ucraina;Europa Centro-Orientale;Europa
58096;San Polo dei Cavalieri;0;2;2;Bielorussia;Europa Centro-Orientale;Europa
58096;San Polo dei Cavalieri;2;0;2;Bosnia-Erzegovina;Europa Centro-Orientale;Europa
58096;San Polo dei Cavalieri;0;2;2;Brasile;America Centro-Meridionale;America
58096;San Polo dei Cavalieri;0;2;2;Germania;Unione Europea;Europa
58096;San Polo dei Cavalieri;1;1;2;Ghana;Africa Occidentale;Africa
58096;San Polo dei Cavalieri;0;2;2;Polonia;Unione Europea;Europa
58096;San Polo dei Cavalieri;1;0;1;Algeria;Africa Settentrionale;Africa
58096;San Polo dei Cavalieri;1;0;1;Argentina;America Centro-Meridionale;America
58096;San Polo dei Cavalieri;0;1;1;Australia;Oceania;Oceania
58096;San Polo dei Cavalieri;1;0;1;Bulgaria;Unione Europea;Europa
58096;San Polo dei Cavalieri;1;0;1;Cinese, Repubblica Popolare;Asia Orientale;Asia
58096;San Polo dei Cavalieri;1;0;1;Congo, Repubblica democratica del (ex Zaire);Africa Centro-Meridionale;Africa
58096;San Polo dei Cavalieri;1;0;1;Costa d'Avorio;Africa Occidentale;Africa
58096;San Polo dei Cavalieri;0;1;1;Dominicana, Repubblica;America Centro-Meridionale;America
58096;San Polo dei Cavalieri;0;1;1;Eritrea;Africa Orientale;Africa
58096;San Polo dei Cavalieri;0;1;1;Georgia;Asia Occidentale;Asia
58096;San Polo dei Cavalieri;0;1;1;Madagascar;Africa Orientale;Africa
58096;San Polo dei Cavalieri;0;1;1;Russa, Federazione;Europa Centro-Orientale;Europa
58096;San Polo dei Cavalieri;1;0;1;Senegal;Africa Occidentale;Africa
58096;San Polo dei Cavalieri;1;0;1;Serbia, Repubblica di;Europa Centro-Orientale;Europa
58096;San Polo dei Cavalieri;1;0;1;Stati Uniti d'America;America Settentrionale;America
58096;San Polo dei Cavalieri;0;1;1;Sud Africa;Africa Centro-Meridionale;Africa
58096;San Polo dei Cavalieri;0;1;1;Svizzera;Altri paesi europei;Europa
58096;San Polo dei Cavalieri;1;0;1;Territori dell'Autonomia Palestinese;Asia Occidentale;Asia
58096;San Polo dei Cavalieri;1;0;1;Tunisia;Africa Settentrionale;Africa
58097;Santa Marinella;322;413;735;Romania;Unione Europea;Europa
58097;Santa Marinella;22;60;82;Ucraina;Europa Centro-Orientale;Europa
58097;Santa Marinella;22;57;79;Filippine;Asia Orientale;Asia
58097;Santa Marinella;24;45;69;Polonia;Unione Europea;Europa
58097;Santa Marinella;38;30;68;India;Asia Centro-Meridionale;Asia
58097;Santa Marinella;21;31;52;Bulgaria;Unione Europea;Europa
58097;Santa Marinella;33;13;46;Bangladesh;Asia Centro-Meridionale;Asia
58097;Santa Marinella;24;21;45;Cinese, Repubblica Popolare;Asia Orientale;Asia
58097;Santa Marinella;20;23;43;Ecuador;America Centro-Meridionale;America
58097;Santa Marinella;14;21;35;Russa, Federazione;Europa Centro-Orientale;Europa
58097;Santa Marinella;13;19;32;Moldova;Europa Centro-Orientale;Europa
58097;Santa Marinella;0;29;29;Madagascar;Africa Orientale;Africa
58097;Santa Marinella;13;14;27;Marocco;Africa Settentrionale;Africa
58097;Santa Marinella;11;14;25;Regno Unito;Altri paesi europei;Europa
58097;Santa Marinella;17;5;22;Egitto;Africa Settentrionale;Africa
58097;Santa Marinella;8;13;21;Germania;Unione Europea;Europa
58097;Santa Marinella;10;9;19;Albania;Europa Centro-Orientale;Europa
58097;Santa Marinella;1;18;19;Brasile;America Centro-Meridionale;America
58097;Santa Marinella;7;10;17;Stati Uniti d'America;America Settentrionale;America
58097;Santa Marinella;6;10;16;Venezuela;America Centro-Meridionale;America
58097;Santa Marinella;3;8;11;Francia;Unione Europea;Europa
58097;Santa Marinella;6;5;11;Nigeria;Africa Occidentale;Africa
58097;Santa Marinella;6;5;11;Sri Lanka (ex Ceylon);Asia Centro-Meridionale;Asia
58097;Santa Marinella;1;9;10;Kenya;Africa Orientale;Africa
58097;Santa Marinella;2;8;10;Spagna;Unione Europea;Europa
58097;Santa Marinella;7;2;9;Colombia;America Centro-Meridionale;America
58097;Santa Marinella;0;9;9;Congo, Repubblica democratica del (ex Zaire);Africa Centro-Meridionale;Africa
58097;Santa Marinella;1;8;9;Cuba;America Centro-Meridionale;America
58097;Santa Marinella;6;3;9;Pakistan;Asia Centro-Meridionale;Asia
58097;Santa Marinella;3;5;8;Bielorussia;Europa Centro-Orientale;Europa
58097;Santa Marinella;1;7;8;Camerun;Africa Centro-Meridionale;Africa
58097;Santa Marinella;5;2;7;Argentina;America Centro-Meridionale;America
58097;Santa Marinella;2;5;7;Perù;America Centro-Meridionale;America
58097;Santa Marinella;5;2;7;Tunisia;Africa Settentrionale;Africa
58097;Santa Marinella;2;4;6;Danimarca;Unione Europea;Europa
58097;Santa Marinella;0;6;6;Tanzania;Africa Orientale;Africa
58097;Santa Marinella;3;3;6;Ungheria;Unione Europea;Europa
58097;Santa Marinella;3;2;5;Algeria;Africa Settentrionale;Africa
58097;Santa Marinella;2;2;4;Austria;Unione Europea;Europa
58097;Santa Marinella;1;3;4;Eritrea;Africa Orientale;Africa
58097;Santa Marinella;4;0;4;Gambia;Africa Occidentale;Africa
58097;Santa Marinella;0;4;4;Giappone;Asia Orientale;Asia
58097;Santa Marinella;0;3;3;Apolide;;
58097;Santa Marinella;0;3;3;El Salvador;America Centro-Meridionale;America
58097;Santa Marinella;3;0;3;Ghana;Africa Occidentale;Africa
58097;Santa Marinella;2;1;3;Iran, Repubblica Islamica del;Asia Occidentale;Asia
58097;Santa Marinella;2;1;3;Lettonia;Unione Europea;Europa
58097;Santa Marinella;3;0;3;Libia;Africa Settentrionale;Africa
58097;Santa Marinella;3;0;3;Mali;Africa Occidentale;Africa
58097;Santa Marinella;1;2;3;Paesi Bassi;Unione Europea;Europa
58097;Santa Marinella;0;3;3;Portogallo;Unione Europea;Europa
58097;Santa Marinella;2;1;3;Senegal;Africa Occidentale;Africa
58097;Santa Marinella;0;3;3;Slovenia;Unione Europea;Europa
58097;Santa Marinella;0;3;3;Svezia;Unione Europea;Europa
58097;Santa Marinella;1;2;3;Svizzera;Altri paesi europei;Europa
58097;Santa Marinella;2;1;3;Turchia;Europa Centro-Orientale;Europa
58097;Santa Marinella;1;1;2;Georgia;Asia Occidentale;Asia
58097;Santa Marinella;1;1;2;Lituania;Unione Europea;Europa
58097;Santa Marinella;0;2;2;Messico;America Centro-Meridionale;America
58097;Santa Marinella;0;2;2;Montenegro;Europa Centro-Orientale;Europa
58097;Santa Marinella;2;0;2;Norvegia;Altri paesi europei;Europa
58097;Santa Marinella;0;2;2;Slovacchia;Unione Europea;Europa
58097;Santa Marinella;0;1;1;Australia;Oceania;Oceania
58097;Santa Marinella;0;1;1;Burundi;Africa Orientale;Africa
58097;Santa Marinella;1;0;1;Canada;America Settentrionale;America
58097;Santa Marinella;0;1;1;Capo Verde;Africa Occidentale;Africa
58097;Santa Marinella;1;0;1;Congo (Repubblica del);Africa Centro-Meridionale;Africa
58097;Santa Marinella;0;1;1;Corea, Repubblica (Corea del Sud);Asia Orientale;Asia
58097;Santa Marinella;1;0;1;Costa d'Avorio;Africa Occidentale;Africa
58097;Santa Marinella;0;1;1;Dominicana, Repubblica;America Centro-Meridionale;America
58097;Santa Marinella;0;1;1;Finlandia;Unione Europea;Europa
58097;Santa Marinella;0;1;1;Giordania;Asia Occidentale;Asia
58097;Santa Marinella;0;1;1;Guatemala;America Centro-Meridionale;America
58097;Santa Marinella;1;0;1;Guinea;Africa Occidentale;Africa
58097;Santa Marinella;0;1;1;Haiti;America Centro-Meridionale;America
58097;Santa Marinella;1;0;1;Israele;Asia Occidentale;Asia
58097;Santa Marinella;1;0;1;Kosovo;Europa Centro-Orientale;Europa
58097;Santa Marinella;0;1;1;Libano;Asia Occidentale;Asia
58097;Santa Marinella;0;1;1;Nicaragua;America Centro-Meridionale;America
58097;Santa Marinella;0;1;1;Nuova Zelanda;Oceania;Oceania
58097;Santa Marinella;1;0;1;San Marino;Altri paesi europei;Europa
58097;Santa Marinella;0;1;1;Sud Africa;Africa Centro-Meridionale;Africa
58097;Santa Marinella;1;0;1;Thailandia;Asia Orientale;Asia
58097;Santa Marinella;0;1;1;Uganda;Africa Orientale;Africa
58098;Sant'Angelo Romano;305;280;585;Romania;Unione Europea;Europa
58098;Sant'Angelo Romano;27;34;61;Albania;Europa Centro-Orientale;Europa
58098;Sant'Angelo Romano;11;12;23;Moldova;Europa Centro-Orientale;Europa
58098;Sant'Angelo Romano;13;4;17;Marocco;Africa Settentrionale;Africa
58098;Sant'Angelo Romano;9;5;14;Egitto;Africa Settentrionale;Africa
58098;Sant'Angelo Romano;2;12;14;Ucraina;Europa Centro-Orientale;Europa
58098;Sant'Angelo Romano;7;3;10;Bangladesh;Asia Centro-Meridionale;Asia
58098;Sant'Angelo Romano;4;4;8;Polonia;Unione Europea;Europa
58098;Sant'Angelo Romano;4;3;7;Pakistan;Asia Centro-Meridionale;Asia
58098;Sant'Angelo Romano;1;6;7;Portogallo;Unione Europea;Europa
58098;Sant'Angelo Romano;5;1;6;Macedonia del Nord;Europa Centro-Orientale;Europa
58098;Sant'Angelo Romano;1;3;4;Croazia;Unione Europea;Europa
58098;Sant'Angelo Romano;1;3;4;Ecuador;America Centro-Meridionale;America
58098;Sant'Angelo Romano;2;2;4;Filippine;Asia Orientale;Asia
58098;Sant'Angelo Romano;4;0;4;India;Asia Centro-Meridionale;Asia
58098;Sant'Angelo Romano;2;2;4;Sri Lanka (ex Ceylon);Asia Centro-Meridionale;Asia
58098;Sant'Angelo Romano;0;3;3;Cuba;America Centro-Meridionale;America
58098;Sant'Angelo Romano;0;3;3;Russa, Federazione;Europa Centro-Orientale;Europa
58098;Sant'Angelo Romano;2;1;3;Serbia, Repubblica di;Europa Centro-Orientale;Europa
58098;Sant'Angelo Romano;1;1;2;Brasile;America Centro-Meridionale;America
58098;Sant'Angelo Romano;1;1;2;Congo (Repubblica del);Africa Centro-Meridionale;Africa
58098;Sant'Angelo Romano;0;2;2;Dominicana, Repubblica;America Centro-Meridionale;America
58098;Sant'Angelo Romano;1;1;2;Etiopia;Africa Orientale;Africa
58098;Sant'Angelo Romano;1;1;2;Guinea;Africa Occidentale;Africa
58098;Sant'Angelo Romano;0;2;2;Lituania;Unione Europea;Europa
58098;Sant'Angelo Romano;2;0;2;Territori dell'Autonomia Palestinese;Asia Occidentale;Asia
58098;Sant'Angelo Romano;2;0;2;Turchia;Europa Centro-Orientale;Europa
58098;Sant'Angelo Romano;1;0;1;Afghanistan;Asia Centro-Meridionale;Asia
58098;Sant'Angelo Romano;1;0;1;Argentina;America Centro-Meridionale;America
58098;Sant'Angelo Romano;0;1;1;Bulgaria;Unione Europea;Europa
58098;Sant'Angelo Romano;1;0;1;Colombia;America Centro-Meridionale;America
58098;Sant'Angelo Romano;1;0;1;El Salvador;America Centro-Meridionale;America
58098;Sant'Angelo Romano;0;1;1;Germania;Unione Europea;Europa
58098;Sant'Angelo Romano;1;0;1;Giordania;Asia Occidentale;Asia
58098;Sant'Angelo Romano;0;1;1;Messico;America Centro-Meridionale;America
58098;Sant'Angelo Romano;1;0;1;Nigeria;Africa Occidentale;Africa
58098;Sant'Angelo Romano;0;1;1;Perù;America Centro-Meridionale;America
58098;Sant'Angelo Romano;1;0;1;Senegal;Africa Occidentale;Africa
58098;Sant'Angelo Romano;0;1;1;Spagna;Unione Europea;Europa
58098;Sant'Angelo Romano;1;0;1;Stati Uniti d'America;America Settentrionale;America
58098;Sant'Angelo Romano;1;0;1;Tanzania;Africa Orientale;Africa
58098;Sant'Angelo Romano;1;0;1;Tunisia;Africa Settentrionale;Africa
58098;Sant'Angelo Romano;0;1;1;Ungheria;Unione Europea;Europa
58099;Sant'Oreste;108;116;224;Romania;Unione Europea;Europa
58099;Sant'Oreste;4;7;11;Moldova;Europa Centro-Orientale;Europa
58099;Sant'Oreste;4;3;7;Egitto;Africa Settentrionale;Africa
58099;Sant'Oreste;4;1;5;Bangladesh;Asia Centro-Meridionale;Asia
58099;Sant'Oreste;1;4;5;Polonia;Unione Europea;Europa
58099;Sant'Oreste;0;5;5;Ucraina;Europa Centro-Orientale;Europa
58099;Sant'Oreste;1;2;3;Bielorussia;Europa Centro-Orientale;Europa
58099;Sant'Oreste;1;2;3;Cuba;America Centro-Meridionale;America
58099;Sant'Oreste;3;0;3;Nigeria;Africa Occidentale;Africa
58099;Sant'Oreste;2;0;2;Algeria;Africa Settentrionale;Africa
58099;Sant'Oreste;0;2;2;Cinese, Repubblica Popolare;Asia Orientale;Asia
58099;Sant'Oreste;1;1;2;Ecuador;America Centro-Meridionale;America
58099;Sant'Oreste;1;1;2;Francia;Unione Europea;Europa
58099;Sant'Oreste;1;1;2;Paesi Bassi;Unione Europea;Europa
58099;Sant'Oreste;0;2;2;Russa, Federazione;Europa Centro-Orientale;Europa
58099;Sant'Oreste;0;2;2;Ungheria;Unione Europea;Europa
58099;Sant'Oreste;1;0;1;Canada;America Settentrionale;America
58099;Sant'Oreste;0;1;1;Dominicana, Repubblica;America Centro-Meridionale;America
58099;Sant'Oreste;0;1;1;Germania;Unione Europea;Europa
58099;Sant'Oreste;0;1;1;Grecia;Unione Europea;Europa
58099;Sant'Oreste;1;0;1;Marocco;Africa Settentrionale;Africa
58099;Sant'Oreste;0;1;1;Mozambico;Africa Orientale;Africa
58099;Sant'Oreste;1;0;1;Perù;America Centro-Meridionale;America
58099;Sant'Oreste;0;1;1;Sierra Leone;Africa Occidentale;Africa
58099;Sant'Oreste;1;0;1;Sri Lanka (ex Ceylon);Asia Centro-Meridionale;Asia
58099;Sant'Oreste;0;1;1;Tunisia;Africa Settentrionale;Africa
58099;Sant'Oreste;1;0;1;Venezuela;America Centro-Meridionale;America
58100;San Vito Romano;74;60;134;Romania;Unione Europea;Europa
58100;San Vito Romano;13;9;22;Nigeria;Africa Occidentale;Africa
58100;San Vito Romano;17;4;21;Egitto;Africa Settentrionale;Africa
58100;San Vito Romano;14;0;14;Bangladesh;Asia Centro-Meridionale;Asia
58100;San Vito Romano;9;2;11;Pakistan;Asia Centro-Meridionale;Asia
58100;San Vito Romano;7;3;10;Albania;Europa Centro-Orientale;Europa
58100;San Vito Romano;9;0;9;Somalia;Africa Orientale;Africa
58100;San Vito Romano;5;0;5;Afghanistan;Asia Centro-Meridionale;Asia
58100;San Vito Romano;4;1;5;Ecuador;America Centro-Meridionale;America
58100;San Vito Romano;4;1;5;Tunisia;Africa Settentrionale;Africa
58100;San Vito Romano;4;0;4;Senegal;Africa Occidentale;Africa
58100;San Vito Romano;1;2;3;Colombia;America Centro-Meridionale;America
58100;San Vito Romano;0;3;3;Ucraina;Europa Centro-Orientale;Europa
58100;San Vito Romano;2;0;2;Costa d'Avorio;Africa Occidentale;Africa
58100;San Vito Romano;1;1;2;Cuba;America Centro-Meridionale;America
58100;San Vito Romano;2;0;2;Gambia;Africa Occidentale;Africa
58100;San Vito Romano;1;1;2;India;Asia Centro-Meridionale;Asia
58100;San Vito Romano;1;1;2;Iran, Repubblica Islamica del;Asia Occidentale;Asia
58100;San Vito Romano;0;2;2;Polonia;Unione Europea;Europa
58100;San Vito Romano;0;2;2;Russa, Federazione;Europa Centro-Orientale;Europa
58100;San Vito Romano;1;1;2;Sud Africa;Africa Centro-Meridionale;Africa
58100;San Vito Romano;1;0;1;Algeria;Africa Settentrionale;Africa
58100;San Vito Romano;1;0;1;Brasile;America Centro-Meridionale;America
58100;San Vito Romano;1;0;1;Burkina Faso (ex Alto Volta);Africa Occidentale;Africa
58100;San Vito Romano;1;0;1;Camerun;Africa Centro-Meridionale;Africa
58100;San Vito Romano;1;0;1;Congo, Repubblica democratica del (ex Zaire);Africa Centro-Meridionale;Africa
58100;San Vito Romano;0;1;1;Etiopia;Africa Orientale;Africa
58100;San Vito Romano;0;1;1;Filippine;Asia Orientale;Asia
58100;San Vito Romano;1;0;1;Ghana;Africa Occidentale;Africa
58100;San Vito Romano;1;0;1;Guinea;Africa Occidentale;Africa
58100;San Vito Romano;1;0;1;Libia;Africa Settentrionale;Africa
58100;San Vito Romano;1;0;1;Mali;Africa Occidentale;Africa
58100;San Vito Romano;0;1;1;Marocco;Africa Settentrionale;Africa
58100;San Vito Romano;0;1;1;Perù;America Centro-Meridionale;America
58100;San Vito Romano;1;0;1;Ruanda;Africa Orientale;Africa
58100;San Vito Romano;1;0;1;Siria;Asia Occidentale;Asia
58100;San Vito Romano;0;1;1;Stati Uniti d'America;America Settentrionale;America
58100;San Vito Romano;1;0;1;Sudan;Africa Settentrionale;Africa
58100;San Vito Romano;1;0;1;Togo;Africa Occidentale;Africa
58100;San Vito Romano;0;1;1;Venezuela;America Centro-Meridionale;America
58100;San Vito Romano;1;0;1;Zimbabwe (ex Rhodesia);Africa Orientale;Africa
58101;Saracinesco;3;2;5;Romania;Unione Europea;Europa
58101;Saracinesco;2;1;3;Nigeria;Africa Occidentale;Africa
58101;Saracinesco;0;1;1;Danimarca;Unione Europea;Europa
58101;Saracinesco;1;0;1;Israele;Asia Occidentale;Asia
58101;Saracinesco;0;1;1;Marocco;Africa Settentrionale;Africa
58101;Saracinesco;0;1;1;Russa, Federazione;Europa Centro-Orientale;Europa
58101;Saracinesco;1;0;1;Tunisia;Africa Settentrionale;Africa
58102;Segni;71;85;156;Romania;Unione Europea;Europa
58102;Segni;31;48;79;Bulgaria;Unione Europea;Europa
58102;Segni;31;32;63;Albania;Europa Centro-Orientale;Europa
58102;Segni;25;14;39;Nigeria;Africa Occidentale;Africa
58102;Segni;23;13;36;Marocco;Africa Settentrionale;Africa
58102;Segni;6;24;30;Ucraina;Europa Centro-Orientale;Europa
58102;Segni;4;8;12;Brasile;America Centro-Meridionale;America
58102;Segni;3;9;12;Spagna;Unione Europea;Europa
58102;Segni;8;4;12;Tunisia;Africa Settentrionale;Africa
58102;Segni;6;5;11;India;Asia Centro-Meridionale;Asia
58102;Segni;7;3;10;Algeria;Africa Settentrionale;Africa
58102;Segni;1;9;10;Argentina;America Centro-Meridionale;America
58102;Segni;5;4;9;Kosovo;Europa Centro-Orientale;Europa
58102;Segni;5;4;9;Macedonia del Nord;Europa Centro-Orientale;Europa
58102;Segni;3;6;9;Polonia;Unione Europea;Europa
58102;Segni;4;4;8;Congo, Repubblica democratica del (ex Zaire);Africa Centro-Meridionale;Africa
58102;Segni;3;5;8;Russa, Federazione;Europa Centro-Orientale;Europa
58102;Segni;2;6;8;Slovacchia;Unione Europea;Europa
58102;Segni;7;0;7;Egitto;Africa Settentrionale;Africa
58102;Segni;5;1;6;Croazia;Unione Europea;Europa
58102;Segni;3;3;6;Francia;Unione Europea;Europa
58102;Segni;1;5;6;Perù;America Centro-Meridionale;America
58102;Segni;4;1;5;Lituania;Unione Europea;Europa
58102;Segni;3;2;5;Regno Unito;Altri paesi europei;Europa
58102;Segni;0;4;4;Filippine;Asia Orientale;Asia
58102;Segni;3;1;4;Moldova;Europa Centro-Orientale;Europa
58102;Segni;1;2;3;Cuba;America Centro-Meridionale;America
58102;Segni;1;2;3;Messico;America Centro-Meridionale;America
58102;Segni;1;1;2;Bolivia;America Centro-Meridionale;America
58102;Segni;2;0;2;Cinese, Repubblica Popolare;Asia Orientale;Asia
58102;Segni;1;1;2;Gabon;Africa Centro-Meridionale;Africa
58102;Segni;0;2;2;Germania;Unione Europea;Europa
58102;Segni;1;1;2;Irlanda;Unione Europea;Europa
58102;Segni;0;2;2;Paesi Bassi;Unione Europea;Europa
58102;Segni;1;1;2;Stati Uniti d'America;America Settentrionale;America
58102;Segni;0;1;1;Azerbaigian;Asia Occidentale;Asia
58102;Segni;1;0;1;Bangladesh;Asia Centro-Meridionale;Asia
58102;Segni;1;0;1;Burkina Faso (ex Alto Volta);Africa Occidentale;Africa
58102;Segni;1;0;1;Camerun;Africa Centro-Meridionale;Africa
58102;Segni;0;1;1;Corea, Repubblica (Corea del Sud);Asia Orientale;Asia
58102;Segni;1;0;1;Costa d'Avorio;Africa Occidentale;Africa
58102;Segni;0;1;1;Dominicana, Repubblica;America Centro-Meridionale;America
58102;Segni;0;1;1;El Salvador;America Centro-Meridionale;America
58102;Segni;0;1;1;Giappone;Asia Orientale;Asia
58102;Segni;0;1;1;Honduras;America Centro-Meridionale;America
58102;Segni;0;1;1;Indonesia;Asia Orientale;Asia
58102;Segni;1;0;1;Senegal;Africa Occidentale;Africa
58102;Segni;0;1;1;Serbia, Repubblica di;Europa Centro-Orientale;Europa
58102;Segni;0;1;1;Slovenia;Unione Europea;Europa
58102;Segni;1;0;1;Somalia;Africa Orientale;Africa
58102;Segni;1;0;1;Sri Lanka (ex Ceylon);Asia Centro-Meridionale;Asia
58102;Segni;0;1;1;Venezuela;America Centro-Meridionale;America
58103;Subiaco;169;189;358;Romania;Unione Europea;Europa
58103;Subiaco;47;51;98;Albania;Europa Centro-Orientale;Europa
58103;Subiaco;23;1;24;Egitto;Africa Settentrionale;Africa
58103;Subiaco;9;6;15;India;Asia Centro-Meridionale;Asia
58103;Subiaco;4;10;14;Perù;America Centro-Meridionale;America
58103;Subiaco;2;12;14;Ucraina;Europa Centro-Orientale;Europa
58103;Subiaco;7;5;12;Nigeria;Africa Occidentale;Africa
58103;Subiaco;3;6;9;Madagascar;Africa Orientale;Africa
58103;Subiaco;4;5;9;Polonia;Unione Europea;Europa
58103;Subiaco;1;7;8;Ecuador;America Centro-Meridionale;America
58103;Subiaco;4;1;5;Ghana;Africa Occidentale;Africa
58103;Subiaco;4;1;5;Pakistan;Asia Centro-Meridionale;Asia
58103;Subiaco;1;4;5;Russa, Federazione;Europa Centro-Orientale;Europa
58103;Subiaco;2;2;4;Cinese, Repubblica Popolare;Asia Orientale;Asia
58103;Subiaco;1;3;4;Filippine;Asia Orientale;Asia
58103;Subiaco;1;3;4;Moldova;Europa Centro-Orientale;Europa
58103;Subiaco;3;1;4;Regno Unito;Altri paesi europei;Europa
58103;Subiaco;3;0;3;Bangladesh;Asia Centro-Meridionale;Asia
58103;Subiaco;1;2;3;Bulgaria;Unione Europea;Europa
58103;Subiaco;2;0;2;Algeria;Africa Settentrionale;Africa
58103;Subiaco;1;1;2;Argentina;America Centro-Meridionale;America
58103;Subiaco;1;1;2;Congo, Repubblica democratica del (ex Zaire);Africa Centro-Meridionale;Africa
58103;Subiaco;2;0;2;Gambia;Africa Occidentale;Africa
58103;Subiaco;2;0;2;Iran, Repubblica Islamica del;Asia Occidentale;Asia
58103;Subiaco;0;2;2;Irlanda;Unione Europea;Europa
58103;Subiaco;1;1;2;Spagna;Unione Europea;Europa
58103;Subiaco;1;1;2;Stati Uniti d'America;America Settentrionale;America
58103;Subiaco;1;0;1;Afghanistan;Asia Centro-Meridionale;Asia
58103;Subiaco;0;1;1;Australia;Oceania;Oceania
58103;Subiaco;0;1;1;Brasile;America Centro-Meridionale;America
58103;Subiaco;1;0;1;Canada;America Settentrionale;America
58103;Subiaco;0;1;1;Capo Verde;Africa Occidentale;Africa
58103;Subiaco;1;0;1;Corea, Repubblica (Corea del Sud);Asia Orientale;Asia
58103;Subiaco;0;1;1;Croazia;Unione Europea;Europa
58103;Subiaco;0;1;1;Cuba;America Centro-Meridionale;America
58103;Subiaco;0;1;1;Kenya;Africa Orientale;Africa
58103;Subiaco;1;0;1;Mali;Africa Occidentale;Africa
58103;Subiaco;1;0;1;Senegal;Africa Occidentale;Africa
58103;Subiaco;0;1;1;Sierra Leone;Africa Occidentale;Africa
58103;Subiaco;1;0;1;Siria;Asia Occidentale;Asia
58103;Subiaco;1;0;1;Slovenia;Unione Europea;Europa
58103;Subiaco;1;0;1;Sudan;Africa Settentrionale;Africa
58103;Subiaco;1;0;1;Tunisia;Africa Settentrionale;Africa
58103;Subiaco;0;1;1;Ungheria;Unione Europea;Europa
58103;Subiaco;1;0;1;Venezuela;America Centro-Meridionale;America
58104;Tivoli;2250;2302;4552;Romania;Unione Europea;Europa
58104;Tivoli;392;110;502;Egitto;Africa Settentrionale;Africa
58104;Tivoli;153;38;191;Bangladesh;Asia Centro-Meridionale;Asia
58104;Tivoli;89;92;181;Albania;Europa Centro-Orientale;Europa
58104;Tivoli;145;31;176;Pakistan;Asia Centro-Meridionale;Asia
58104;Tivoli;62;102;164;Moldova;Europa Centro-Orientale;Europa
58104;Tivoli;63;60;123;Cinese, Repubblica Popolare;Asia Orientale;Asia
58104;Tivoli;37;86;123;Ucraina;Europa Centro-Orientale;Europa
58104;Tivoli;42;74;116;Polonia;Unione Europea;Europa
58104;Tivoli;59;52;111;Nigeria;Africa Occidentale;Africa
58104;Tivoli;46;63;109;Perù;America Centro-Meridionale;America
58104;Tivoli;49;25;74;Marocco;Africa Settentrionale;Africa
58104;Tivoli;42;31;73;Tunisia;Africa Settentrionale;Africa
58104;Tivoli;59;9;68;Afghanistan;Asia Centro-Meridionale;Asia
58104;Tivoli;41;11;52;India;Asia Centro-Meridionale;Asia
58104;Tivoli;16;21;37;Etiopia;Africa Orientale;Africa
58104;Tivoli;19;16;35;Ghana;Africa Occidentale;Africa
58104;Tivoli;24;11;35;Senegal;Africa Occidentale;Africa
58104;Tivoli;11;22;33;Cuba;America Centro-Meridionale;America
58104;Tivoli;18;10;28;Algeria;Africa Settentrionale;Africa
58104;Tivoli;8;20;28;Filippine;Asia Orientale;Asia
58104;Tivoli;6;19;25;Brasile;America Centro-Meridionale;America
58104;Tivoli;11;12;23;Bulgaria;Unione Europea;Europa
58104;Tivoli;12;11;23;Ecuador;America Centro-Meridionale;America
58104;Tivoli;17;5;22;Turchia;Europa Centro-Orientale;Europa
58104;Tivoli;8;12;20;Colombia;America Centro-Meridionale;America
58104;Tivoli;10;10;20;Sri Lanka (ex Ceylon);Asia Centro-Meridionale;Asia
58104;Tivoli;9;9;18;Iran, Repubblica Islamica del;Asia Occidentale;Asia
58104;Tivoli;7;11;18;Macedonia del Nord;Europa Centro-Orientale;Europa
58104;Tivoli;9;9;18;Serbia, Repubblica di;Europa Centro-Orientale;Europa
58104;Tivoli;1;16;17;Spagna;Unione Europea;Europa
58104;Tivoli;6;10;16;Congo, Repubblica democratica del (ex Zaire);Africa Centro-Meridionale;Africa
58104;Tivoli;15;0;15;Mali;Africa Occidentale;Africa
58104;Tivoli;6;8;14;Croazia;Unione Europea;Europa
58104;Tivoli;13;0;13;Gambia;Africa Occidentale;Africa
58104;Tivoli;4;8;12;Bolivia;America Centro-Meridionale;America
58104;Tivoli;4;8;12;Venezuela;America Centro-Meridionale;America
58104;Tivoli;6;5;11;Siria;Asia Occidentale;Asia
58104;Tivoli;5;5;10;Costa d'Avorio;Africa Occidentale;Africa
58104;Tivoli;9;1;10;Eritrea;Africa Orientale;Africa
58104;Tivoli;9;1;10;Messico;America Centro-Meridionale;America
58104;Tivoli;0;10;10;Russa, Federazione;Europa Centro-Orientale;Europa
58104;Tivoli;3;6;9;Ceca, Repubblica;Unione Europea;Europa
58104;Tivoli;4;5;9;Germania;Unione Europea;Europa
58104;Tivoli;3;5;8;Bosnia-Erzegovina;Europa Centro-Orientale;Europa
58104;Tivoli;1;7;8;Dominicana, Repubblica;America Centro-Meridionale;America
58104;Tivoli;2;6;8;El Salvador;America Centro-Meridionale;America
58104;Tivoli;6;2;8;Kosovo;Europa Centro-Orientale;Europa
58104;Tivoli;3;5;8;Regno Unito;Altri paesi europei;Europa
58104;Tivoli;0;8;8;Stati Uniti d'America;America Settentrionale;America
58104;Tivoli;4;3;7;Paesi Bassi;Unione Europea;Europa
58104;Tivoli;4;2;6;Camerun;Africa Centro-Meridionale;Africa
58104;Tivoli;1;5;6;Capo Verde;Africa Occidentale;Africa
58104;Tivoli;1;5;6;Francia;Unione Europea;Europa
58104;Tivoli;6;0;6;Guinea;Africa Occidentale;Africa
58104;Tivoli;0;6;6;Slovacchia;Unione Europea;Europa
58104;Tivoli;1;5;6;Thailandia;Asia Orientale;Asia
58104;Tivoli;2;3;5;Grecia;Unione Europea;Europa
58104;Tivoli;3;2;5;Somalia;Africa Orientale;Africa
58104;Tivoli;1;3;4;Argentina;America Centro-Meridionale;America
58104;Tivoli;1;3;4;Austria;Unione Europea;Europa
58104;Tivoli;0;4;4;Bielorussia;Europa Centro-Orientale;Europa
58104;Tivoli;2;2;4;Burkina Faso (ex Alto Volta);Africa Occidentale;Africa
58104;Tivoli;4;0;4;Iraq;Asia Occidentale;Asia
58104;Tivoli;2;2;4;Libia;Africa Settentrionale;Africa
58104;Tivoli;1;3;4;Ruanda;Africa Orientale;Africa
58104;Tivoli;2;1;3;Angola;Africa Centro-Meridionale;Africa
58104;Tivoli;1;2;3;Libano;Asia Occidentale;Asia
58104;Tivoli;3;0;3;Niger;Africa Occidentale;Africa
58104;Tivoli;1;2;3;San Marino;Altri paesi europei;Europa
58104;Tivoli;2;1;3;Territori dell'Autonomia Palestinese;Asia Occidentale;Asia
58104;Tivoli;0;3;3;Ungheria;Unione Europea;Europa
58104;Tivoli;1;1;2;Apolide;;
58104;Tivoli;0;2;2;Australia;Oceania;Oceania
58104;Tivoli;0;2;2;Belgio;Unione Europea;Europa
58104;Tivoli;1;1;2;Danimarca;Unione Europea;Europa
58104;Tivoli;1;1;2;Gabon;Africa Centro-Meridionale;Africa
58104;Tivoli;0;2;2;Georgia;Asia Occidentale;Asia
58104;Tivoli;0;2;2;Giappone;Asia Orientale;Asia
58104;Tivoli;2;0;2;Giordania;Asia Occidentale;Asia
58104;Tivoli;1;1;2;Guatemala;America Centro-Meridionale;America
58104;Tivoli;2;0;2;Guinea Bissau;Africa Occidentale;Africa
58104;Tivoli;0;2;2;Kenya;Africa Orientale;Africa
58104;Tivoli;0;2;2;Lettonia;Unione Europea;Europa
58104;Tivoli;0;2;2;Lituania;Unione Europea;Europa
58104;Tivoli;0;2;2;Madagascar;Africa Orientale;Africa
58104;Tivoli;1;1;2;Sudan;Africa Settentrionale;Africa
58104;Tivoli;1;1;2;Svizzera;Altri paesi europei;Europa
58104;Tivoli;1;1;2;Uzbekistan;Asia Centro-Meridionale;Asia
58104;Tivoli;1;0;1;Burundi;Africa Orientale;Africa
58104;Tivoli;0;1;1;Congo (Repubblica del);Africa Centro-Meridionale;Africa
58104;Tivoli;0;1;1;Costa Rica;America Centro-Meridionale;America
58104;Tivoli;0;1;1;Giamaica;America Centro-Meridionale;America
58104;Tivoli;0;1;1;Irlanda;Unione Europea;Europa
58104;Tivoli;1;0;1;Israele;Asia Occidentale;Asia
58104;Tivoli;1;0;1;Liberia;Africa Occidentale;Africa
58104;Tivoli;1;0;1;Malaysia;Asia Orientale;Asia
58104;Tivoli;0;1;1;Malta;Unione Europea;Europa
58104;Tivoli;0;1;1;Mongolia;Asia Orientale;Asia
58104;Tivoli;0;1;1;Nepal;Asia Centro-Meridionale;Asia
58104;Tivoli;1;0;1;Nicaragua;America Centro-Meridionale;America
58104;Tivoli;0;1;1;Norvegia;Altri paesi europei;Europa
58104;Tivoli;0;1;1;Portogallo;Unione Europea;Europa
58104;Tivoli;0;1;1;Slovenia;Unione Europea;Europa
58104;Tivoli;0;1;1;Stato della Città del Vaticano;Altri paesi europei;Europa
58104;Tivoli;0;1;1;Sud Africa;Africa Centro-Meridionale;Africa
58104;Tivoli;0;1;1;Togo;Africa Occidentale;Africa
58104;Tivoli;0;1;1;Uruguay;America Centro-Meridionale;America
58105;Tolfa;94;100;194;Romania;Unione Europea;Europa
58105;Tolfa;19;12;31;Albania;Europa Centro-Orientale;Europa
58105;Tolfa;8;7;15;Macedonia del Nord;Europa Centro-Orientale;Europa
58105;Tolfa;8;5;13;Egitto;Africa Settentrionale;Africa
58105;Tolfa;4;5;9;Bulgaria;Unione Europea;Europa
58105;Tolfa;4;3;7;Kosovo;Europa Centro-Orientale;Europa
58105;Tolfa;4;3;7;Norvegia;Altri paesi europei;Europa
58105;Tolfa;1;6;7;Polonia;Unione Europea;Europa
58105;Tolfa;3;3;6;Marocco;Africa Settentrionale;Africa
58105;Tolfa;0;6;6;Perù;America Centro-Meridionale;America
58105;Tolfa;2;3;5;Cinese, Repubblica Popolare;Asia Orientale;Asia
58105;Tolfa;2;3;5;Filippine;Asia Orientale;Asia
58105;Tolfa;4;1;5;India;Asia Centro-Meridionale;Asia
58105;Tolfa;0;4;4;Russa, Federazione;Europa Centro-Orientale;Europa
58105;Tolfa;1;2;3;Bielorussia;Europa Centro-Orientale;Europa
58105;Tolfa;3;0;3;Tunisia;Africa Settentrionale;Africa
58105;Tolfa;0;2;2;Brasile;America Centro-Meridionale;America
58105;Tolfa;0;2;2;Ecuador;America Centro-Meridionale;America
58105;Tolfa;1;1;2;Nigeria;Africa Occidentale;Africa
58105;Tolfa;0;2;2;Spagna;Unione Europea;Europa
58105;Tolfa;1;1;2;Sri Lanka (ex Ceylon);Asia Centro-Meridionale;Asia
58105;Tolfa;0;2;2;Ucraina;Europa Centro-Orientale;Europa
58105;Tolfa;0;1;1;Austria;Unione Europea;Europa
58105;Tolfa;1;0;1;Costa d'Avorio;Africa Occidentale;Africa
58105;Tolfa;1;0;1;Moldova;Europa Centro-Orientale;Europa
58105;Tolfa;1;0;1;Regno Unito;Altri paesi europei;Europa
58105;Tolfa;0;1;1;Stati Uniti d'America;America Settentrionale;America
58106;Torrita Tiberina;18;29;47;Romania;Unione Europea;Europa
58106;Torrita Tiberina;7;8;15;India;Asia Centro-Meridionale;Asia
58106;Torrita Tiberina;6;2;8;Etiopia;Africa Orientale;Africa
58106;Torrita Tiberina;5;2;7;Afghanistan;Asia Centro-Meridionale;Asia
58106;Torrita Tiberina;3;4;7;Polonia;Unione Europea;Europa
58106;Torrita Tiberina;3;2;5;Bangladesh;Asia Centro-Meridionale;Asia
58106;Torrita Tiberina;2;3;5;Egitto;Africa Settentrionale;Africa
58106;Torrita Tiberina;2;2;4;Albania;Europa Centro-Orientale;Europa
58106;Torrita Tiberina;1;3;4;Ucraina;Europa Centro-Orientale;Europa
58106;Torrita Tiberina;2;1;3;Regno Unito;Altri paesi europei;Europa
58106;Torrita Tiberina;1;1;2;Belgio;Unione Europea;Europa
58106;Torrita Tiberina;1;1;2;Filippine;Asia Orientale;Asia
58106;Torrita Tiberina;0;2;2;Portogallo;Unione Europea;Europa
58106;Torrita Tiberina;0;1;1;Colombia;America Centro-Meridionale;America
58106;Torrita Tiberina;1;0;1;Congo, Repubblica democratica del (ex Zaire);Africa Centro-Meridionale;Africa
58106;Torrita Tiberina;0;1;1;Danimarca;Unione Europea;Europa
58106;Torrita Tiberina;1;0;1;Eritrea;Africa Orientale;Africa
58106;Torrita Tiberina;0;1;1;Finlandia;Unione Europea;Europa
58106;Torrita Tiberina;0;1;1;Grecia;Unione Europea;Europa
58106;Torrita Tiberina;1;0;1;Sri Lanka (ex Ceylon);Asia Centro-Meridionale;Asia
58106;Torrita Tiberina;0;1;1;Stati Uniti d'America;America Settentrionale;America
58106;Torrita Tiberina;1;0;1;Tunisia;Africa Settentrionale;Africa
58106;Torrita Tiberina;0;1;1;Ungheria;Unione Europea;Europa
58107;Trevignano Romano;205;210;415;Romania;Unione Europea;Europa
58107;Trevignano Romano;28;34;62;Polonia;Unione Europea;Europa
58107;Trevignano Romano;26;32;58;Regno Unito;Altri paesi europei;Europa
58107;Trevignano Romano;23;21;44;Albania;Europa Centro-Orientale;Europa
58107;Trevignano Romano;13;16;29;Germania;Unione Europea;Europa
58107;Trevignano Romano;7;11;18;Sri Lanka (ex Ceylon);Asia Centro-Meridionale;Asia
58107;Trevignano Romano;12;5;17;India;Asia Centro-Meridionale;Asia
58107;Trevignano Romano;6;11;17;Ucraina;Europa Centro-Orientale;Europa
58107;Trevignano Romano;5;10;15;Stati Uniti d'America;America Settentrionale;America
58107;Trevignano Romano;3;9;12;Filippine;Asia Orientale;Asia
58107;Trevignano Romano;8;4;12;Paesi Bassi;Unione Europea;Europa
58107;Trevignano Romano;6;3;9;Irlanda;Unione Europea;Europa
58107;Trevignano Romano;1;8;9;Russa, Federazione;Europa Centro-Orientale;Europa
58107;Trevignano Romano;4;4;8;Moldova;Europa Centro-Orientale;Europa
58107;Trevignano Romano;1;6;7;Francia;Unione Europea;Europa
58107;Trevignano Romano;2;4;6;Cinese, Repubblica Popolare;Asia Orientale;Asia
58107;Trevignano Romano;3;2;5;Belgio;Unione Europea;Europa
58107;Trevignano Romano;2;2;4;Brasile;America Centro-Meridionale;America
58107;Trevignano Romano;2;2;4;Norvegia;Altri paesi europei;Europa
58107;Trevignano Romano;2;2;4;Perù;America Centro-Meridionale;America
58107;Trevignano Romano;2;1;3;Australia;Oceania;Oceania
58107;Trevignano Romano;3;0;3;Bangladesh;Asia Centro-Meridionale;Asia
58107;Trevignano Romano;1;2;3;Bulgaria;Unione Europea;Europa
58107;Trevignano Romano;1;2;3;Colombia;America Centro-Meridionale;America
58107;Trevignano Romano;1;2;3;Cuba;America Centro-Meridionale;America
58107;Trevignano Romano;2;1;3;Egitto;Africa Settentrionale;Africa
58107;Trevignano Romano;2;1;3;Svezia;Unione Europea;Europa
58107;Trevignano Romano;0;2;2;Argentina;America Centro-Meridionale;America
58107;Trevignano Romano;1;1;2;Austria;Unione Europea;Europa
58107;Trevignano Romano;1;1;2;Canada;America Settentrionale;America
58107;Trevignano Romano;2;0;2;Congo, Repubblica democratica del (ex Zaire);Africa Centro-Meridionale;Africa
58107;Trevignano Romano;2;0;2;Ecuador;America Centro-Meridionale;America
58107;Trevignano Romano;0;2;2;Eritrea;Africa Orientale;Africa
58107;Trevignano Romano;1;1;2;Finlandia;Unione Europea;Europa
58107;Trevignano Romano;0;2;2;Giappone;Asia Orientale;Asia
58107;Trevignano Romano;1;1;2;Spagna;Unione Europea;Europa
58107;Trevignano Romano;1;1;2;Sud Africa;Africa Centro-Meridionale;Africa
58107;Trevignano Romano;1;1;2;Svizzera;Altri paesi europei;Europa
58107;Trevignano Romano;0;2;2;Venezuela;America Centro-Meridionale;America
58107;Trevignano Romano;0;1;1;Algeria;Africa Settentrionale;Africa
58107;Trevignano Romano;0;1;1;Bielorussia;Europa Centro-Orientale;Europa
58107;Trevignano Romano;1;0;1;Capo Verde;Africa Occidentale;Africa
58107;Trevignano Romano;0;1;1;Corea, Repubblica (Corea del Sud);Asia Orientale;Asia
58107;Trevignano Romano;0;1;1;Dominicana, Repubblica;America Centro-Meridionale;America
58107;Trevignano Romano;0;1;1;Grecia;Unione Europea;Europa
58107;Trevignano Romano;0;1;1;Lussemburgo;Unione Europea;Europa
58107;Trevignano Romano;1;0;1;Madagascar;Africa Orientale;Africa
58107;Trevignano Romano;0;1;1;Malaysia;Asia Orientale;Asia
58107;Trevignano Romano;1;0;1;Malta;Unione Europea;Europa
58107;Trevignano Romano;0;1;1;Marocco;Africa Settentrionale;Africa
58107;Trevignano Romano;0;1;1;Nigeria;Africa Occidentale;Africa
58107;Trevignano Romano;1;0;1;Pakistan;Asia Centro-Meridionale;Asia
58107;Trevignano Romano;1;0;1;Senegal;Africa Occidentale;Africa
58107;Trevignano Romano;1;0;1;Somalia;Africa Orientale;Africa
58107;Trevignano Romano;1;0;1;Tunisia;Africa Settentrionale;Africa
58108;Vallepietra;2;4;6;Romania;Unione Europea;Europa
58108;Vallepietra;0;3;3;Bulgaria;Unione Europea;Europa
58109;Vallinfreda;13;14;27;Romania;Unione Europea;Europa
58109;Vallinfreda;4;0;4;Egitto;Africa Settentrionale;Africa
58109;Vallinfreda;3;0;3;Nigeria;Africa Occidentale;Africa
58109;Vallinfreda;0;1;1;Albania;Europa Centro-Orientale;Europa
58109;Vallinfreda;1;0;1;Corea, Repubblica (Corea del Sud);Asia Orientale;Asia
58109;Vallinfreda;0;1;1;Moldova;Europa Centro-Orientale;Europa
58109;Vallinfreda;0;1;1;Polonia;Unione Europea;Europa
58109;Vallinfreda;0;1;1;Russa, Federazione;Europa Centro-Orientale;Europa
58109;Vallinfreda;1;0;1;Venezuela;America Centro-Meridionale;America
58110;Valmontone;499;464;963;Romania;Unione Europea;Europa
58110;Valmontone;38;35;73;Albania;Europa Centro-Orientale;Europa
58110;Valmontone;32;31;63;Marocco;Africa Settentrionale;Africa
58110;Valmontone;36;26;62;Nigeria;Africa Occidentale;Africa
58110;Valmontone;27;25;52;Cinese, Repubblica Popolare;Asia Orientale;Asia
58110;Valmontone;21;15;36;Pakistan;Asia Centro-Meridionale;Asia
58110;Valmontone;11;20;31;Macedonia del Nord;Europa Centro-Orientale;Europa
58110;Valmontone;20;4;24;Bangladesh;Asia Centro-Meridionale;Asia
58110;Valmontone;21;2;23;Egitto;Africa Settentrionale;Africa
58110;Valmontone;16;7;23;India;Asia Centro-Meridionale;Asia
58110;Valmontone;14;7;21;Tunisia;Africa Settentrionale;Africa
58110;Valmontone;10;10;20;Kosovo;Europa Centro-Orientale;Europa
58110;Valmontone;5;15;20;Polonia;Unione Europea;Europa
58110;Valmontone;9;8;17;Bulgaria;Unione Europea;Europa
58110;Valmontone;2;13;15;Ucraina;Europa Centro-Orientale;Europa
58110;Valmontone;1;13;14;Dominicana, Repubblica;America Centro-Meridionale;America
58110;Valmontone;6;8;14;Moldova;Europa Centro-Orientale;Europa
58110;Valmontone;3;10;13;Camerun;Africa Centro-Meridionale;Africa
58110;Valmontone;9;4;13;Congo (Repubblica del);Africa Centro-Meridionale;Africa
58110;Valmontone;3;10;13;Ecuador;America Centro-Meridionale;America
58110;Valmontone;5;7;12;Perù;America Centro-Meridionale;America
58110;Valmontone;5;6;11;Brasile;America Centro-Meridionale;America
58110;Valmontone;6;3;9;Colombia;America Centro-Meridionale;America
58110;Valmontone;0;7;7;Russa, Federazione;Europa Centro-Orientale;Europa
58110;Valmontone;3;3;6;Venezuela;America Centro-Meridionale;America
58110;Valmontone;0;5;5;Cuba;America Centro-Meridionale;America
58110;Valmontone;3;2;5;Guinea;Africa Occidentale;Africa
58110;Valmontone;4;1;5;Siria;Asia Occidentale;Asia
58110;Valmontone;2;2;4;Angola;Africa Centro-Meridionale;Africa
58110;Valmontone;1;3;4;Congo, Repubblica democratica del (ex Zaire);Africa Centro-Meridionale;Africa
58110;Valmontone;0;4;4;Spagna;Unione Europea;Europa
58110;Valmontone;1;2;3;Filippine;Asia Orientale;Asia
58110;Valmontone;2;1;3;Iraq;Asia Occidentale;Asia
58110;Valmontone;3;0;3;Mauritania;Africa Occidentale;Africa
58110;Valmontone;3;0;3;Senegal;Africa Occidentale;Africa
58110;Valmontone;2;0;2;Algeria;Africa Settentrionale;Africa
58110;Valmontone;1;1;2;Capo Verde;Africa Occidentale;Africa
58110;Valmontone;0;2;2;Croazia;Unione Europea;Europa
58110;Valmontone;1;1;2;Francia;Unione Europea;Europa
58110;Valmontone;2;0;2;Gambia;Africa Occidentale;Africa
58110;Valmontone;0;2;2;Georgia;Asia Occidentale;Asia
58110;Valmontone;2;0;2;Ghana;Africa Occidentale;Africa
58110;Valmontone;1;1;2;Giordania;Asia Occidentale;Asia
58110;Valmontone;0;2;2;Kirghizistan;Asia Centro-Meridionale;Asia
58110;Valmontone;2;0;2;Mali;Africa Occidentale;Africa
58110;Valmontone;0;2;2;Messico;America Centro-Meridionale;America
58110;Valmontone;2;0;2;Montenegro;Europa Centro-Orientale;Europa
58110;Valmontone;1;1;2;Portogallo;Unione Europea;Europa
58110;Valmontone;2;0;2;Regno Unito;Altri paesi europei;Europa
58110;Valmontone;1;1;2;Sierra Leone;Africa Occidentale;Africa
58110;Valmontone;1;1;2;Stati Uniti d'America;America Settentrionale;America
58110;Valmontone;1;1;2;Territori dell'Autonomia Palestinese;Asia Occidentale;Asia
58110;Valmontone;2;0;2;Turchia;Europa Centro-Orientale;Europa
58110;Valmontone;1;0;1;Afghanistan;Asia Centro-Meridionale;Asia
58110;Valmontone;0;1;1;Armenia;Asia Occidentale;Asia
58110;Valmontone;0;1;1;Bielorussia;Europa Centro-Orientale;Europa
58110;Valmontone;1;0;1;Bosnia-Erzegovina;Europa Centro-Orientale;Europa
58110;Valmontone;0;1;1;Burkina Faso (ex Alto Volta);Africa Occidentale;Africa
58110;Valmontone;0;1;1;Canada;America Settentrionale;America
58110;Valmontone;0;1;1;Ceca, Repubblica;Unione Europea;Europa
58110;Valmontone;1;0;1;Cile;America Centro-Meridionale;America
58110;Valmontone;1;0;1;Etiopia;Africa Orientale;Africa
58110;Valmontone;0;1;1;Germania;Unione Europea;Europa
58110;Valmontone;1;0;1;Iran, Repubblica Islamica del;Asia Occidentale;Asia
58110;Valmontone;0;1;1;Kazakhstan;Asia Centro-Meridionale;Asia
58110;Valmontone;0;1;1;Kenya;Africa Orientale;Africa
58110;Valmontone;1;0;1;Libia;Africa Settentrionale;Africa
58110;Valmontone;1;0;1;Serbia, Repubblica di;Europa Centro-Orientale;Europa
58110;Valmontone;0;1;1;Slovacchia;Unione Europea;Europa
58110;Valmontone;0;1;1;Sud Africa;Africa Centro-Meridionale;Africa
58110;Valmontone;0;1;1;Svizzera;Altri paesi europei;Europa
58110;Valmontone;1;0;1;Togo;Africa Occidentale;Africa
58111;Velletri;1181;1202;2383;Romania;Unione Europea;Europa
58111;Velletri;192;150;342;Marocco;Africa Settentrionale;Africa
58111;Velletri;224;113;337;India;Asia Centro-Meridionale;Asia
58111;Velletri;176;146;322;Albania;Europa Centro-Orientale;Europa
58111;Velletri;139;51;190;Tunisia;Africa Settentrionale;Africa
58111;Velletri;50;136;186;Ucraina;Europa Centro-Orientale;Europa
58111;Velletri;79;19;98;Egitto;Africa Settentrionale;Africa
58111;Velletri;41;41;82;Cinese, Repubblica Popolare;Asia Orientale;Asia
58111;Velletri;31;50;81;Polonia;Unione Europea;Europa
58111;Velletri;31;45;76;Moldova;Europa Centro-Orientale;Europa
58111;Velletri;54;12;66;Bangladesh;Asia Centro-Meridionale;Asia
58111;Velletri;29;24;53;Nigeria;Africa Occidentale;Africa
58111;Velletri;30;22;52;Senegal;Africa Occidentale;Africa
58111;Velletri;15;26;41;Brasile;America Centro-Meridionale;America
58111;Velletri;28;2;30;Pakistan;Asia Centro-Meridionale;Asia
58111;Velletri;5;25;30;Russa, Federazione;Europa Centro-Orientale;Europa
58111;Velletri;11;14;25;Filippine;Asia Orientale;Asia
58111;Velletri;13;10;23;Bosnia-Erzegovina;Europa Centro-Orientale;Europa
58111;Velletri;8;14;22;Germania;Unione Europea;Europa
58111;Velletri;10;12;22;Regno Unito;Altri paesi europei;Europa
58111;Velletri;12;10;22;Turchia;Europa Centro-Orientale;Europa
58111;Velletri;16;5;21;Algeria;Africa Settentrionale;Africa
58111;Velletri;8;13;21;Francia;Unione Europea;Europa
58111;Velletri;5;15;20;Bulgaria;Unione Europea;Europa
58111;Velletri;6;14;20;Perù;America Centro-Meridionale;America
58111;Velletri;12;6;18;Macedonia del Nord;Europa Centro-Orientale;Europa
58111;Velletri;1;15;16;Argentina;America Centro-Meridionale;America
58111;Velletri;5;11;16;Ecuador;America Centro-Meridionale;America
58111;Velletri;3;12;15;Spagna;Unione Europea;Europa
58111;Velletri;11;3;14;Ghana;Africa Occidentale;Africa
58111;Velletri;3;10;13;Cuba;America Centro-Meridionale;America
58111;Velletri;7;6;13;Siria;Asia Occidentale;Asia
58111;Velletri;5;8;13;Stati Uniti d'America;America Settentrionale;America
58111;Velletri;3;9;12;Venezuela;America Centro-Meridionale;America
58111;Velletri;5;4;9;Colombia;America Centro-Meridionale;America
58111;Velletri;8;1;9;Mali;Africa Occidentale;Africa
58111;Velletri;5;4;9;Sri Lanka (ex Ceylon);Asia Centro-Meridionale;Asia
58111;Velletri;8;0;8;Gambia;Africa Occidentale;Africa
58111;Velletri;4;4;8;Togo;Africa Occidentale;Africa
58111;Velletri;3;4;7;Iraq;Asia Occidentale;Asia
58111;Velletri;6;1;7;Serbia, Repubblica di;Europa Centro-Orientale;Europa
58111;Velletri;3;3;6;Georgia;Asia Occidentale;Asia
58111;Velletri;2;4;6;Libano;Asia Occidentale;Asia
58111;Velletri;1;5;6;Portogallo;Unione Europea;Europa
58111;Velletri;2;3;5;Belgio;Unione Europea;Europa
58111;Velletri;1;4;5;Bielorussia;Europa Centro-Orientale;Europa
58111;Velletri;1;4;5;Dominicana, Repubblica;America Centro-Meridionale;America
58111;Velletri;5;0;5;Guinea;Africa Occidentale;Africa
58111;Velletri;2;3;5;Irlanda;Unione Europea;Europa
58111;Velletri;0;5;5;Messico;America Centro-Meridionale;America
58111;Velletri;2;2;4;Armenia;Asia Occidentale;Asia
58111;Velletri;2;2;4;Benin (ex Dahomey);Africa Occidentale;Africa
58111;Velletri;4;0;4;Camerun;Africa Centro-Meridionale;Africa
58111;Velletri;3;1;4;Costa d'Avorio;Africa Occidentale;Africa
58111;Velletri;1;3;4;Croazia;Unione Europea;Europa
58111;Velletri;3;1;4;Kosovo;Europa Centro-Orientale;Europa
58111;Velletri;0;4;4;Mauritius;Africa Orientale;Africa
58111;Velletri;1;3;4;Paraguay;America Centro-Meridionale;America
58111;Velletri;0;4;4;Slovacchia;Unione Europea;Europa
58111;Velletri;0;4;4;Svezia;Unione Europea;Europa
58111;Velletri;1;2;3;Canada;America Settentrionale;America
58111;Velletri;0;3;3;Cile;America Centro-Meridionale;America
58111;Velletri;1;2;3;Etiopia;Africa Orientale;Africa
58111;Velletri;3;0;3;Giordania;Asia Occidentale;Asia
58111;Velletri;0;3;3;Haiti;America Centro-Meridionale;America
58111;Velletri;1;2;3;Israele;Asia Occidentale;Asia
58111;Velletri;3;0;3;Somalia;Africa Orientale;Africa
58111;Velletri;1;1;2;Afghanistan;Asia Centro-Meridionale;Asia
58111;Velletri;0;2;2;Austria;Unione Europea;Europa
58111;Velletri;1;1;2;Congo (Repubblica del);Africa Centro-Meridionale;Africa
58111;Velletri;0;2;2;Corea, Repubblica (Corea del Sud);Asia Orientale;Asia
58111;Velletri;0;2;2;El Salvador;America Centro-Meridionale;America
58111;Velletri;0;2;2;Finlandia;Unione Europea;Europa
58111;Velletri;2;0;2;Libia;Africa Settentrionale;Africa
58111;Velletri;2;0;2;Svizzera;Altri paesi europei;Europa
58111;Velletri;0;1;1;Apolide;;
58111;Velletri;1;0;1;Australia;Oceania;Oceania
58111;Velletri;0;1;1;Ceca, Repubblica;Unione Europea;Europa
58111;Velletri;1;0;1;Ciad;Africa Centro-Meridionale;Africa
58111;Velletri;0;1;1;Congo, Repubblica democratica del (ex Zaire);Africa Centro-Meridionale;Africa
58111;Velletri;0;1;1;Dominica;America Centro-Meridionale;America
58111;Velletri;0;1;1;Gabon;Africa Centro-Meridionale;Africa
58111;Velletri;0;1;1;Giappone;Asia Orientale;Asia
58111;Velletri;1;0;1;Iran, Repubblica Islamica del;Asia Occidentale;Asia
58111;Velletri;0;1;1;Kazakhstan;Asia Centro-Meridionale;Asia
58111;Velletri;1;0;1;Liberia;Africa Occidentale;Africa
58111;Velletri;0;1;1;Lituania;Unione Europea;Europa
58111;Velletri;0;1;1;Lussemburgo;Unione Europea;Europa
58111;Velletri;0;1;1;Nicaragua;America Centro-Meridionale;America
58111;Velletri;1;0;1;Sierra Leone;Africa Occidentale;Africa
58111;Velletri;0;1;1;Slovenia;Unione Europea;Europa
58111;Velletri;1;0;1;Sudan;Africa Settentrionale;Africa
58111;Velletri;1;0;1;Territori dell'Autonomia Palestinese;Asia Occidentale;Asia
58111;Velletri;1;0;1;Ungheria;Unione Europea;Europa
58111;Velletri;1;0;1;Uruguay;America Centro-Meridionale;America
58112;Vicovaro;114;137;251;Romania;Unione Europea;Europa
58112;Vicovaro;5;2;7;Egitto;Africa Settentrionale;Africa
58112;Vicovaro;2;3;5;Albania;Europa Centro-Orientale;Europa
58112;Vicovaro;2;2;4;Moldova;Europa Centro-Orientale;Europa
58112;Vicovaro;0;4;4;Ucraina;Europa Centro-Orientale;Europa
58112;Vicovaro;2;1;3;Cinese, Repubblica Popolare;Asia Orientale;Asia
58112;Vicovaro;1;2;3;Polonia;Unione Europea;Europa
58112;Vicovaro;0;2;2;Brasile;America Centro-Meridionale;America
58112;Vicovaro;2;0;2;Cuba;America Centro-Meridionale;America
58112;Vicovaro;1;0;1;Argentina;America Centro-Meridionale;America
58112;Vicovaro;0;1;1;Ecuador;America Centro-Meridionale;America
58112;Vicovaro;0;1;1;Filippine;Asia Orientale;Asia
58112;Vicovaro;0;1;1;Georgia;Asia Occidentale;Asia
58112;Vicovaro;1;0;1;Ghana;Africa Occidentale;Africa
58112;Vicovaro;1;0;1;Iran, Repubblica Islamica del;Asia Occidentale;Asia
58112;Vicovaro;0;1;1;Kenya;Africa Orientale;Africa
58112;Vicovaro;0;1;1;Marocco;Africa Settentrionale;Africa
58112;Vicovaro;0;1;1;Russa, Federazione;Europa Centro-Orientale;Europa
58112;Vicovaro;1;0;1;Senegal;Africa Occidentale;Africa
58112;Vicovaro;0;1;1;Tunisia;Africa Settentrionale;Africa
58112;Vicovaro;0;1;1;Venezuela;America Centro-Meridionale;America
58112;Vicovaro;0;1;1;Zimbabwe (ex Rhodesia);Africa Orientale;Africa
58113;Vivaro Romano;3;6;9;Romania;Unione Europea;Europa
58113;Vivaro Romano;1;0;1;Bangladesh;Asia Centro-Meridionale;Asia
58114;Zagarolo;821;779;1600;Romania;Unione Europea;Europa
58114;Zagarolo;57;61;118;Albania;Europa Centro-Orientale;Europa
58114;Zagarolo;46;17;63;Marocco;Africa Settentrionale;Africa
58114;Zagarolo;36;24;60;Nigeria;Africa Occidentale;Africa
58114;Zagarolo;15;29;44;Moldova;Europa Centro-Orientale;Europa
58114;Zagarolo;21;17;38;Croazia;Unione Europea;Europa
58114;Zagarolo;2;27;29;Ucraina;Europa Centro-Orientale;Europa
58114;Zagarolo;9;16;25;Cinese, Repubblica Popolare;Asia Orientale;Asia
58114;Zagarolo;14;10;24;Kosovo;Europa Centro-Orientale;Europa
58114;Zagarolo;13;11;24;Polonia;Unione Europea;Europa
58114;Zagarolo;11;8;19;India;Asia Centro-Meridionale;Asia
58114;Zagarolo;9;8;17;Bosnia-Erzegovina;Europa Centro-Orientale;Europa
58114;Zagarolo;6;11;17;Regno Unito;Altri paesi europei;Europa
58114;Zagarolo;14;3;17;Tunisia;Africa Settentrionale;Africa
58114;Zagarolo;12;4;16;Bangladesh;Asia Centro-Meridionale;Asia
58114;Zagarolo;10;5;15;Senegal;Africa Occidentale;Africa
58114;Zagarolo;4;10;14;Bulgaria;Unione Europea;Europa
58114;Zagarolo;5;8;13;Filippine;Asia Orientale;Asia
58114;Zagarolo;3;9;12;Cuba;America Centro-Meridionale;America
58114;Zagarolo;4;8;12;Francia;Unione Europea;Europa
58114;Zagarolo;10;1;11;Egitto;Africa Settentrionale;Africa
58114;Zagarolo;9;2;11;Gambia;Africa Occidentale;Africa
58114;Zagarolo;2;9;11;Perù;America Centro-Meridionale;America
58114;Zagarolo;4;6;10;El Salvador;America Centro-Meridionale;America
58114;Zagarolo;5;4;9;Sri Lanka (ex Ceylon);Asia Centro-Meridionale;Asia
58114;Zagarolo;1;7;8;Spagna;Unione Europea;Europa
58114;Zagarolo;4;3;7;Pakistan;Asia Centro-Meridionale;Asia
58114;Zagarolo;5;2;7;Serbia, Repubblica di;Europa Centro-Orientale;Europa
58114;Zagarolo;3;3;6;Ecuador;America Centro-Meridionale;America
58114;Zagarolo;3;2;5;Camerun;Africa Centro-Meridionale;Africa
58114;Zagarolo;3;2;5;Capo Verde;Africa Occidentale;Africa
58114;Zagarolo;2;3;5;Etiopia;Africa Orientale;Africa
58114;Zagarolo;1;4;5;Germania;Unione Europea;Europa
58114;Zagarolo;1;4;5;Giappone;Asia Orientale;Asia
58114;Zagarolo;2;3;5;Venezuela;America Centro-Meridionale;America
58114;Zagarolo;2;2;4;Brasile;America Centro-Meridionale;America
58114;Zagarolo;3;1;4;Macedonia del Nord;Europa Centro-Orientale;Europa
58114;Zagarolo;4;0;4;Mali;Africa Occidentale;Africa
58114;Zagarolo;3;1;4;Paesi Bassi;Unione Europea;Europa
58114;Zagarolo;1;2;3;Austria;Unione Europea;Europa
58114;Zagarolo;3;0;3;Costa d'Avorio;Africa Occidentale;Africa
58114;Zagarolo;0;3;3;Iran, Repubblica Islamica del;Asia Occidentale;Asia
58114;Zagarolo;0;3;3;Kenya;Africa Orientale;Africa
58114;Zagarolo;1;2;3;Libano;Asia Occidentale;Asia
58114;Zagarolo;1;2;3;Niger;Africa Occidentale;Africa
58114;Zagarolo;0;3;3;Russa, Federazione;Europa Centro-Orientale;Europa
58114;Zagarolo;1;1;2;Apolide;;
58114;Zagarolo;0;2;2;Ceca, Repubblica;Unione Europea;Europa
58114;Zagarolo;2;0;2;Colombia;America Centro-Meridionale;America
58114;Zagarolo;0;2;2;Congo (Repubblica del);Africa Centro-Meridionale;Africa
58114;Zagarolo;0;2;2;Congo, Repubblica democratica del (ex Zaire);Africa Centro-Meridionale;Africa
58114;Zagarolo;1;1;2;Eritrea;Africa Orientale;Africa
58114;Zagarolo;0;2;2;Finlandia;Unione Europea;Europa
58114;Zagarolo;2;0;2;Iraq;Asia Occidentale;Asia
58114;Zagarolo;0;2;2;Lituania;Unione Europea;Europa
58114;Zagarolo;1;1;2;Slovenia;Unione Europea;Europa
58114;Zagarolo;0;2;2;Stati Uniti d'America;America Settentrionale;America
58114;Zagarolo;1;1;2;Svezia;Unione Europea;Europa
58114;Zagarolo;1;0;1;Afghanistan;Asia Centro-Meridionale;Asia
58114;Zagarolo;1;0;1;Algeria;Africa Settentrionale;Africa
58114;Zagarolo;0;1;1;Argentina;America Centro-Meridionale;America
58114;Zagarolo;0;1;1;Belgio;Unione Europea;Europa
58114;Zagarolo;0;1;1;Bielorussia;Europa Centro-Orientale;Europa
58114;Zagarolo;0;1;1;Burkina Faso (ex Alto Volta);Africa Occidentale;Africa
58114;Zagarolo;0;1;1;Burundi;Africa Orientale;Africa
58114;Zagarolo;0;1;1;Canada;America Settentrionale;America
58114;Zagarolo;1;0;1;Cile;America Centro-Meridionale;America
58114;Zagarolo;0;1;1;Dominicana, Repubblica;America Centro-Meridionale;America
58114;Zagarolo;1;0;1;Grecia;Unione Europea;Europa
58114;Zagarolo;0;1;1;Guatemala;America Centro-Meridionale;America
58114;Zagarolo;0;1;1;Honduras;America Centro-Meridionale;America
58114;Zagarolo;0;1;1;Irlanda;Unione Europea;Europa
58114;Zagarolo;0;1;1;Kazakhstan;Asia Centro-Meridionale;Asia
58114;Zagarolo;0;1;1;Kirghizistan;Asia Centro-Meridionale;Asia
58114;Zagarolo;1;0;1;Libia;Africa Settentrionale;Africa
58114;Zagarolo;1;0;1;Mauritania;Africa Occidentale;Africa
58114;Zagarolo;0;1;1;Messico;America Centro-Meridionale;America
58114;Zagarolo;1;0;1;Montenegro;Europa Centro-Orientale;Europa
58114;Zagarolo;0;1;1;Portogallo;Unione Europea;Europa
58114;Zagarolo;1;0;1;San Marino;Altri paesi europei;Europa
58114;Zagarolo;1;0;1;Siria;Asia Occidentale;Asia
58114;Zagarolo;1;0;1;Turchia;Europa Centro-Orientale;Europa
58114;Zagarolo;0;1;1;Ungheria;Unione Europea;Europa
